	記号,一般,*,*,*,*,*
マップ	名詞,一般,*,*,*,*,マップ,マップ,マップ
で	助詞,格助詞,一般,*,*,*,で,デ,デ
地図	名詞,一般,*,*,*,*,地図,チズ,チズ
を	助詞,格助詞,一般,*,*,*,を,ヲ,ヲ
検索	名詞,サ変接続,*,*,*,*,検索,ケンサク,ケンサク
。	記号,句点,*,*,*,*,。,。,。
乗換	名詞,一般,*,*,*,*,乗換,ノリカエ,ノリカエ
案内	名詞,サ変接続,*,*,*,*,案内,アンナイ,アンナイ
、	記号,読点,*,*,*,*,、,、,、
路線	名詞,一般,*,*,*,*,路線,ロセン,ロセン
図	名詞,接尾,一般,*,*,*,図,ズ,ズ
ドライブ	名詞,サ変接続,*,*,*,*,ドライブ,ドライブ,ドライブ
ルート	名詞,一般,*,*,*,*,ルート,ルート,ルート
ストリートビュー	名詞,一般,*,*,*,*,*
も	助詞,係助詞,*,*,*,*,も,モ,モ
見	動詞,自立,*,*,一段,連用形,見る,ミ,ミ
やすい	形容詞,非自立,*,*,形容詞・アウオ段,基本形,やすい,ヤスイ,ヤスイ
お	接頭詞,名詞接続,*,*,*,*,お,オ,オ
店	名詞,一般,*,*,*,*,店,ミセ,ミセ
や	助詞,並立助詞,*,*,*,*,や,ヤ,ヤ
サービス	名詞,サ変接続,*,*,*,*,サービス,サービス,サービス
地域	名詞,一般,*,*,*,*,地域,チイキ,チイキ
の	助詞,連体化,*,*,*,*,の,ノ,ノ
情報	名詞,一般,*,*,*,*,情報,ジョウホウ,ジョーホー
でき	動詞,自立,*,*,一段,連用形,できる,デキ,デキ
ます	助動詞,*,*,*,特殊・マス,基本形,ます,マス,マス
世界	名詞,一般,*,*,*,*,世界,セカイ,セカイ
日本語	名詞,一般,*,*,*,*,日本語,ニホンゴ,ニホンゴ
旅	名詞,サ変接続,*,*,*,*,旅,タビ,タビ
プラン	名詞,一般,*,*,*,*,プラン,プラン,プラン
に	助詞,格助詞,一般,*,*,*,に,ニ,ニ
便利	名詞,形容動詞語幹,*,*,*,*,便利,ベンリ,ベンリ
\	名詞,サ変接続,*,*,*,*,*
日本	名詞,固有名詞,地域,国,*,*,日本,ニッポン,ニッポン
開い	動詞,自立,*,*,五段・カ行イ音便,連用タ接続,開く,ヒライ,ヒライ
て	助詞,接続助詞,*,*,*,*,て,テ,テ
い	動詞,非自立,*,*,一段,連用形,いる,イ,イ
この	連体詞,*,*,*,*,*,この,コノ,コノ
は	助詞,係助詞,*,*,*,*,は,ハ,ワ
現在	名詞,副詞可能,*,*,*,*,現在,ゲンザイ,ゲンザイ
ご	接頭詞,名詞接続,*,*,*,*,ご,ゴ,ゴ
利用	名詞,サ変接続,*,*,*,*,利用,リヨウ,リヨー
いただけ	動詞,自立,*,*,一段,連用形,いただける,イタダケ,イタダケ
ませ	助動詞,*,*,*,特殊・マス,未然形,ます,マセ,マセ
ん	助動詞,*,*,*,不変化型,基本形,ん,ン,ン
しばらく	副詞,助詞類接続,*,*,*,*,しばらく,シバラク,シバラク
し	動詞,自立,*,*,サ変・スル,連用形,する,シ,シ
から	助詞,格助詞,一般,*,*,*,から,カラ,カラ
もう一度	副詞,一般,*,*,*,*,もう一度,モウイチド,モーイチド
試し	動詞,自立,*,*,五段・サ行,連用形,試す,タメシ,タメシ
ください	動詞,非自立,*,*,五段・ラ行特殊,命令ｉ,くださる,クダサイ,クダサイ
（	記号,括弧開,*,*,*,*,（,（,（
代理	名詞,サ変接続,*,*,*,*,代理,ダイリ,ダイリ
デフォルト	名詞,一般,*,*,*,*,デフォルト,デフォルト,デフォルト
ページ	名詞,一般,*,*,*,*,ページ,ページ,ページ
\\	名詞,サ変接続,*,*,*,*,*
詳細	名詞,形容動詞語幹,*,*,*,*,詳細,ショウサイ,ショーサイ
海外	名詞,一般,*,*,*,*,海外,カイガイ,カイガイ
日本人	名詞,一般,*,*,*,*,日本人,ニッポンジン,ニッポンジン
サッカー	名詞,一般,*,*,*,*,サッカー,サッカー,サッカー
選手	名詞,一般,*,*,*,*,選手,センシュ,センシュ
小規模	名詞,形容動詞語幹,*,*,*,*,小規模,ショウキボ,ショーキボ
事業	名詞,一般,*,*,*,*,事業,ジギョウ,ジギョー
者	名詞,接尾,一般,*,*,*,者,シャ,シャ
支援	名詞,サ変接続,*,*,*,*,支援,シエン,シエン
する	動詞,自立,*,*,サ変・スル,基本形,する,スル,スル
有効	名詞,形容動詞語幹,*,*,*,*,有効,ユウコウ,ユーコー
表示	名詞,サ変接続,*,*,*,*,表示,ヒョウジ,ヒョージ
一覧	名詞,サ変接続,*,*,*,*,一覧,イチラン,イチラン
スポーツナビ	名詞,一般,*,*,*,*,*
スポーツ	名詞,一般,*,*,*,*,スポーツ,スポーツ,スポーツ
総合	名詞,サ変接続,*,*,*,*,総合,ソウゴウ,ソーゴー
サイト	名詞,一般,*,*,*,*,サイト,サイト,サイト
スポナビ	名詞,固有名詞,一般,*,*,*,*
）	記号,括弧閉,*,*,*,*,）,）,）
です	助動詞,*,*,*,特殊・デス,基本形,です,デス,デス
最新	名詞,一般,*,*,*,*,最新,サイシン,サイシン
ニュース	名詞,一般,*,*,*,*,ニュース,ニュース,ニュース
速報	名詞,サ変接続,*,*,*,*,速報,ソクホウ,ソクホー
コラム	名詞,一般,*,*,*,*,コラム,コラム,コラム
日程	名詞,一般,*,*,*,*,日程,ニッテイ,ニッテイ
結果	名詞,副詞可能,*,*,*,*,結果,ケッカ,ケッカ
順位	名詞,一般,*,*,*,*,順位,ジュンイ,ジュンイ
など	助詞,副助詞,*,*,*,*,など,ナド,ナド
素早く	形容詞,自立,*,*,形容詞・アウオ段,連用テ接続,素早い,スバヤク,スバヤク
届け	名詞,一般,*,*,*,*,届け,トドケ,トドケ
欧州	名詞,固有名詞,地域,一般,*,*,欧州,オウシュウ,オーシュー
ヘルプ	名詞,一般,*,*,*,*,ヘルプ,ヘルプ,ヘルプ
キーワード	名詞,一般,*,*,*,*,キーワード,キーワード,キーワード
ウェブ	名詞,一般,*,*,*,*,*
もっと	副詞,一般,*,*,*,*,もっと,モット,モット
に	助詞,副詞化,*,*,*,*,に,ニ,ニ
新規	名詞,一般,*,*,*,*,新規,シンキ,シンキ
取得	名詞,サ変接続,*,*,*,*,取得,シュトク,シュトク
ログイン	名詞,一般,*,*,*,*,ログイン,ログイン,ログイン
トップ	名詞,一般,*,*,*,*,トップ,トップ,トップ
プロ	名詞,一般,*,*,*,*,プロ,プロ,プロ
野球	名詞,一般,*,*,*,*,野球,ヤキュウ,ヤキュー
高校	名詞,一般,*,*,*,*,高校,コウコウ,コーコー
侍	名詞,一般,*,*,*,*,侍,サムライ,サムライ
ジャパン	名詞,固有名詞,地域,国,*,*,ジャパン,ジャパン,ジャパン
リーグ	名詞,一般,*,*,*,*,リーグ,リーグ,リーグ
代表	名詞,サ変接続,*,*,*,*,代表,ダイヒョウ,ダイヒョー
競馬	名詞,一般,*,*,*,*,競馬,ケイバ,ケイバ
ゴルフ	名詞,一般,*,*,*,*,ゴルフ,ゴルフ,ゴルフ
フィギュア	名詞,一般,*,*,*,*,フィギュア,フィギュア,フィギュア
バレー	名詞,一般,*,*,*,*,バレー,バレー,バレー
テニス	名詞,一般,*,*,*,*,テニス,テニス,テニス
バスケ	名詞,一般,*,*,*,*,バスケ,バスケ,バスケ
格闘技	名詞,一般,*,*,*,*,格闘技,カクトウギ,カクトーギ
大相撲	名詞,一般,*,*,*,*,大相撲,オオズモウ,オーズモー
ラグビー	名詞,一般,*,*,*,*,ラグビー,ラグビー,ラグビー
陸上	名詞,一般,*,*,*,*,陸上,リクジョウ,リクジョー
ボートレース	名詞,一般,*,*,*,*,ボートレース,ボートレース,ボートレース
他	接頭詞,名詞接続,*,*,*,*,他,タ,タ
競技	名詞,サ変接続,*,*,*,*,競技,キョウギ,キョーギ
ライブ	名詞,一般,*,*,*,*,ライブ,ライブ,ライブ
スポナビ	名詞,一般,*,*,*,*,*
イングランド	名詞,固有名詞,地域,一般,*,*,イングランド,イングランド,イングランド
イタリア	名詞,固有名詞,地域,国,*,*,イタリア,イタリア,イタリア
スペイン	名詞,固有名詞,地域,国,*,*,スペイン,スペイン,スペイン
ドイツ	名詞,固有名詞,地域,国,*,*,ドイツ,ドイツ,ドイツ
オランダ	名詞,固有名詞,地域,国,*,*,オランダ,オランダ,オランダ
フランス	名詞,固有名詞,地域,国,*,*,フランス,フランス,フランス
ポルトガル	名詞,固有名詞,地域,国,*,*,ポルトガル,ポルトガル,ポルトガル
ベルギー	名詞,固有名詞,地域,国,*,*,ベルギー,ベルギー,ベルギー
動画	名詞,一般,*,*,*,*,動画,ドウガ,ドーガ
公式	名詞,形容動詞語幹,*,*,*,*,公式,コウシキ,コーシキ
が	助詞,格助詞,一般,*,*,*,が,ガ,ガ
無効	名詞,形容動詞語幹,*,*,*,*,無効,ムコウ,ムコー
すべて	名詞,副詞可能,*,*,*,*,すべて,スベテ,スベテ
機能	名詞,サ変接続,*,*,*,*,機能,キノウ,キノー
ため	名詞,非自立,副詞可能,*,*,*,ため,タメ,タメ
設定	名詞,サ変接続,*,*,*,*,設定,セッテイ,セッテイ
方法	名詞,一般,*,*,*,*,方法,ホウホウ,ホーホー
について	助詞,格助詞,連語,*,*,*,について,ニツイテ,ニツイテ
「	記号,括弧開,*,*,*,*,「,「,「
ご覧	名詞,動詞非自立的,*,*,*,*,ご覧,ゴラン,ゴラン
ください	動詞,自立,*,*,五段・ラ行特殊,命令ｉ,くださる,クダサイ,クダサイ
浅野	名詞,固有名詞,人名,姓,*,*,浅野,アサノ,アサノ
拓磨	名詞,固有名詞,人名,姓,*,*,拓磨,タクマ,タクマ
キックオフ	名詞,一般,*,*,*,*,キックオフ,キックオフ,キックオフ
出場	名詞,サ変接続,*,*,*,*,出場,シュツジョウ,シュツジョー
状況	名詞,一般,*,*,*,*,状況,ジョウキョウ,ジョーキョー
ホーム	名詞,一般,*,*,*,*,ホーム,ホーム,ホーム
試合	名詞,サ変接続,*,*,*,*,試合,シアイ,シアイ
アウェイ	名詞,一般,*,*,*,*,*
得点	名詞,サ変接続,*,*,*,*,得点,トクテン,トクテン
日	名詞,固有名詞,地域,国,*,*,日,ニチ,ニチ
ボーフム	名詞,一般,*,*,*,*,*
前	接頭詞,名詞接続,*,*,*,*,前,ゼン,ゼン
アウグスブルク	名詞,一般,*,*,*,*,*
見る	動詞,自立,*,*,一段,基本形,見る,ミル,ミル
井手口	名詞,固有名詞,人名,姓,*,*,井手口,イデグチ,イデグチ
陽介	名詞,固有名詞,人名,名,*,*,陽介,ヨウスケ,ヨースケ
ロス・カウンティ	名詞,一般,*,*,*,*,*
セルティック	名詞,一般,*,*,*,*,*
伊東	名詞,固有名詞,人名,姓,*,*,伊東,イトウ,イトー
純	名詞,固有名詞,人名,名,*,*,純,ジュン,ジュン
也	名詞,一般,*,*,*,*,*
ゲント	名詞,一般,*,*,*,*,*
ゲンク	名詞,一般,*,*,*,*,*
伊藤	名詞,固有名詞,人名,姓,*,*,伊藤,イトウ,イトー
洋	名詞,固有名詞,人名,名,*,*,洋,ヒロシ,ヒロシ
輝	名詞,一般,*,*,*,*,輝,テル,テル
ヘルタ	名詞,一般,*,*,*,*,*
シュツットガルト	名詞,固有名詞,地域,一般,*,*,シュツットガルト,シュツットガルト,シュツットガルト
遠藤	名詞,固有名詞,人名,姓,*,*,遠藤,エンドウ,エンドー
渓	名詞,固有名詞,人名,名,*,*,渓,ケイ,ケイ
太	名詞,固有名詞,人名,名,*,*,太,フトシ,フトシ
土	名詞,一般,*,*,*,*,土,ド,ド
ライプツィヒ	名詞,一般,*,*,*,*,*
ウニオン	名詞,固有名詞,組織,*,*,*,ウニオン,ウニオン,ウニオン
・	記号,一般,*,*,*,*,・,・,・
ベルリン	名詞,固有名詞,地域,一般,*,*,ベルリン,ベルリン,ベルリン
航	名詞,固有名詞,人名,名,*,*,航,ワタル,ワタル
奥川	名詞,固有名詞,人名,姓,*,*,奥川,オクガワ,オクガワ
雅也	名詞,固有名詞,人名,名,*,*,雅也,マサヤ,マサヤ
ケルン	名詞,固有名詞,地域,一般,*,*,ケルン,ケルン,ケルン
アルミニア・ビーレフェルト	名詞,一般,*,*,*,*,*
香川	名詞,固有名詞,人名,姓,*,*,香川,カガワ,カガワ
真司	名詞,固有名詞,人名,名,*,*,真司,シンジ,シンジ
途中	名詞,副詞可能,*,*,*,*,途中,トチュウ,トチュー
交代	名詞,サ変接続,*,*,*,*,交代,コウタイ,コータイ
後半	名詞,副詞可能,*,*,*,*,後半,コウハン,コーハン
分	名詞,接尾,助数詞,*,*,*,分,フン,フン
シント・トラウデン	名詞,一般,*,*,*,*,*
終了	名詞,サ変接続,*,*,*,*,終了,シュウリョウ,シューリョー
ハイライト	名詞,一般,*,*,*,*,ハイライト,ハイライト,ハイライト
スタンダール・リエージュ	名詞,一般,*,*,*,*,*
鎌田	名詞,固有名詞,人名,姓,*,*,鎌田,カマタ,カマタ
大地	名詞,固有名詞,人名,名,*,*,大地,ダイチ,ダイチ
アイン	名詞,固有名詞,人名,姓,*,*,アイン,アイン,アイン
トラ	名詞,固有名詞,人名,名,*,*,トラ,トラ,トラ
ハト	名詞,一般,*,*,*,*,ハト,ハト,ハト
フランクフルト	名詞,固有名詞,地域,一般,*,*,フランクフルト,フランクフルト,フランクフルト
ホッフェンハイム	名詞,一般,*,*,*,*,*
川	名詞,接尾,地域,*,*,*,川,ガワ,ガワ
﨑修	名詞,固有名詞,組織,*,*,*,*
平	接頭詞,名詞接続,*,*,*,*,平,ヒラ,ヒラ
ポルティモネンセ	名詞,一般,*,*,*,*,*
モレイレンセ	名詞,一般,*,*,*,*,*
﨑修	名詞,一般,*,*,*,*,*
平	名詞,一般,*,*,*,*,平,タイラ,タイラ
川島	名詞,固有名詞,人名,姓,*,*,川島,カワシマ,カワシマ
永	名詞,固有名詞,人名,名,*,*,永,ヒサシ,ヒサシ
嗣	名詞,一般,*,*,*,*,*
水	名詞,一般,*,*,*,*,水,ミズ,ミズ
せ	動詞,自立,*,*,サ変・スル,未然ヌ接続,する,セ,セ
ず	助動詞,*,*,*,特殊・ヌ,連用ニ接続,ぬ,ズ,ズ
ストラスブール	名詞,固有名詞,地域,一般,*,*,ストラスブール,ストラスブール,ストラスブール
レンヌ	名詞,一般,*,*,*,*,*
久保	名詞,固有名詞,人名,姓,*,*,久保,クボ,クボ
建	名詞,固有名詞,人名,名,*,*,建,ケン,ケン
英	名詞,固有名詞,地域,国,*,*,英,エイ,エイ
火	名詞,一般,*,*,*,*,火,ヒ,ヒ
マヨルカ	名詞,固有名詞,地域,一般,*,*,マヨルカ,マヨルカ,マヨルカ
アラベス	名詞,一般,*,*,*,*,*
坂元	名詞,固有名詞,人名,姓,*,*,坂元,サカモト,サカモト
達	名詞,固有名詞,人名,名,*,*,達,イタル,イタル
裕	名詞,固有名詞,人名,名,*,*,裕,ヒロシ,ヒロシ
前半	名詞,一般,*,*,*,*,前半,ゼンハン,ゼンハン
オイペン	名詞,一般,*,*,*,*,*
オーステンデ	名詞,一般,*,*,*,*,*
シュミット	名詞,固有名詞,人名,姓,*,*,シュミット,シュミット,シュミット
ダニエル	名詞,固有名詞,人名,姓,*,*,ダニエル,ダニエル,ダニエル
フル	名詞,形容動詞語幹,*,*,*,*,フル,フル,フル
菅原	名詞,固有名詞,人名,姓,*,*,菅原,スガワラ,スガワラ
由	名詞,固有名詞,人名,名,*,*,由,ユカリ,ユカリ
勢	名詞,接尾,一般,*,*,*,勢,ゼイ,ゼイ
ヘーレンフェーン	名詞,一般,*,*,*,*,*
鈴木	名詞,固有名詞,人名,姓,*,*,鈴木,スズキ,スズキ
武蔵	名詞,固有名詞,人名,名,*,*,武蔵,ムサシ,ムサシ
ユニオン・サン・ジロワーズ	名詞,一般,*,*,*,*,*
ベールスホット	名詞,一般,*,*,*,*,*
田川	名詞,固有名詞,人名,姓,*,*,田川,タガワ,タガワ
亨	名詞,固有名詞,人名,名,*,*,亨,トオル,トール
介	名詞,サ変接続,*,*,*,*,介,カイ,カイ
サンタクララ	名詞,一般,*,*,*,*,*
マルティモ	名詞,一般,*,*,*,*,*
堂	名詞,接尾,一般,*,*,*,堂,ドウ,ドー
安	名詞,接尾,一般,*,*,*,安,ヤス,ヤス
律	名詞,一般,*,*,*,*,律,リツ,リツ
カンブール・レーバーデン	名詞,一般,*,*,*,*,*
冨	名詞,固有名詞,一般,*,*,*,冨,トミ,トミ
安	名詞,固有名詞,人名,姓,*,*,安,アン,アン
健	名詞,固有名詞,人名,名,*,*,健,ケン,ケン
洋	名詞,一般,*,*,*,*,洋,ヨウ,ヨー
アーセナル	名詞,一般,*,*,*,*,*
マンチェスター	名詞,固有名詞,地域,一般,*,*,マンチェスター,マンチェスター,マンチェスター
ユナイテッド	名詞,固有名詞,組織,*,*,*,ユナイテッド,ユナイテッド,ユナイテッド
中島	名詞,固有名詞,人名,姓,*,*,中島,ナカジマ,ナカジマ
翔	名詞,固有名詞,人名,名,*,*,翔,ショウ,ショー
哉	名詞,一般,*,*,*,*,*
中村	名詞,固有名詞,人名,姓,*,*,中村,ナカムラ,ナカムラ
輔	名詞,一般,*,*,*,*,*
中山	名詞,固有名詞,人名,姓,*,*,中山,ナカヤマ,ナカヤマ
雄太	名詞,固有名詞,人名,名,*,*,雄太,ユウタ,ユータ
ワールワイク	名詞,一般,*,*,*,*,*
ズウォレ	名詞,一般,*,*,*,*,*
橋岡	名詞,固有名詞,人名,姓,*,*,橋岡,ハシオカ,ハシオカ
大樹	名詞,固有名詞,人名,名,*,*,大樹,ダイキ,ダイキ
長谷部	名詞,固有名詞,人名,姓,*,*,長谷部,ハセベ,ハセベ
誠	名詞,固有名詞,人名,名,*,*,誠,マコト,マコト
旗手	名詞,一般,*,*,*,*,旗手,キシュ,キシュ
怜	名詞,固有名詞,人名,名,*,*,怜,レイ,レイ
央	名詞,固有名詞,人名,名,*,*,央,ヒサシ,ヒサシ
林	名詞,接尾,一般,*,*,*,林,リン,リン
大地	名詞,一般,*,*,*,*,大地,ダイチ,ダイチ
原	接頭詞,名詞接続,*,*,*,*,原,ゲン,ゲン
大智	名詞,一般,*,*,*,*,大智,タイチ,タイチ
原口	名詞,固有名詞,地域,一般,*,*,原口,ハラグチ,ハラグチ
元気	名詞,形容動詞語幹,*,*,*,*,元気,ゲンキ,ゲンキ
ファン・ウェルメスケルケン	名詞,一般,*,*,*,*,*
際	名詞,接尾,一般,*,*,*,際,ギワ,ギワ
藤本	名詞,固有名詞,人名,姓,*,*,藤本,フジモト,フジモト
寛	名詞,固有名詞,人名,名,*,*,寛,ヒロシ,ヒロシ
ジル・ヴィセンテ	名詞,一般,*,*,*,*,*
パソス・デ・フェレイラ	名詞,一般,*,*,*,*,*
古橋	名詞,固有名詞,人名,姓,*,*,古橋,フルハシ,フルハシ
梧	名詞,一般,*,*,*,*,*
前田	名詞,固有名詞,人名,姓,*,*,前田,マエダ,マエダ
大	名詞,固有名詞,人名,名,*,*,大,マサル,マサル
然	副詞,一般,*,*,*,*,然,シカ,シカ
直輝	名詞,固有名詞,人名,名,*,*,直輝,ナオキ,ナオキ
フェイエノールト	名詞,一般,*,*,*,*,*
ユトレヒト	名詞,固有名詞,地域,一般,*,*,ユトレヒト,ユトレヒト,ユトレヒト
町田	名詞,固有名詞,人名,姓,*,*,町田,マチダ,マチダ
浩樹	名詞,固有名詞,人名,名,*,*,浩樹,ヒロキ,ヒロキ
アンデルレヒト	名詞,一般,*,*,*,*,*
松原	名詞,一般,*,*,*,*,松原,マツバラ,マツバラ
后	名詞,一般,*,*,*,*,后,キサキ,キサキ
三	名詞,数,*,*,*,*,三,サン,サン
笘薫	名詞,一般,*,*,*,*,*
南野	名詞,固有名詞,組織,*,*,*,南野,ミナミノ,ミナミノ
拓実	名詞,固有名詞,地域,一般,*,*,拓実,タクジツ,タクジツ
リヴァプール	名詞,一般,*,*,*,*,*
エヴァートン	名詞,一般,*,*,*,*,*
三好	名詞,固有名詞,人名,姓,*,*,三好,ミヨシ,ミヨシ
康	名詞,固有名詞,人名,名,*,*,康,ヤスシ,ヤスシ
児	名詞,接尾,一般,*,*,*,児,ジ,ジ
クラブ	名詞,一般,*,*,*,*,クラブ,クラブ,クラブ
ブルージュ	名詞,一般,*,*,*,*,*
アントワープ	名詞,固有名詞,地域,一般,*,*,アントワープ,アントワープ,アントワープ
食	名詞,接尾,一般,*,*,*,食,ショク,ショク
野	名詞,一般,*,*,*,*,野,ノ,ノ
亮太	名詞,固有名詞,人名,名,*,*,亮太,リョウタ,リョータ
郎	名詞,一般,*,*,*,*,郎,ロウ,ロー
エストリル・プライア	名詞,一般,*,*,*,*,*
ベレネンセス	名詞,一般,*,*,*,*,*
森岡	名詞,固有名詞,人名,姓,*,*,森岡,モリオカ,モリオカ
メヘレン	名詞,一般,*,*,*,*,*
シャルルロワ	名詞,一般,*,*,*,*,*
守田	名詞,固有名詞,人名,姓,*,*,守田,モリタ,モリタ
英正	名詞,固有名詞,人名,名,*,*,英正,ヒデマサ,ヒデマサ
吉田	名詞,固有名詞,人名,姓,*,*,吉田,ヨシダ,ヨシダ
麻也	名詞,固有名詞,人名,名,*,*,麻也,マヤ,マヤ
ヴェローナ	名詞,一般,*,*,*,*,*
サンプドリア	名詞,一般,*,*,*,*,*
渡辺	名詞,固有名詞,人名,姓,*,*,渡辺,ワタナベ,ワタナベ
剛	名詞,固有名詞,人名,名,*,*,剛,ツヨシ,ツヨシ
コルトレイク	名詞,一般,*,*,*,*,*
ある	動詞,自立,*,*,五段・ラ行,基本形,ある,アル,アル
時間	名詞,副詞可能,*,*,*,*,時間,ジカン,ジカン
予定	名詞,サ変接続,*,*,*,*,予定,ヨテイ,ヨテイ
時刻	名詞,一般,*,*,*,*,時刻,ジコク,ジコク
変更	名詞,サ変接続,*,*,*,*,変更,ヘンコウ,ヘンコー
さ	動詞,自立,*,*,サ変・スル,未然レル接続,する,サ,サ
れる	動詞,接尾,*,*,一段,基本形,れる,レル,レル
場合	名詞,副詞可能,*,*,*,*,場合,バアイ,バアイ
あり	動詞,自立,*,*,五段・ラ行,連用形,ある,アリ,アリ
日時	名詞,一般,*,*,*,*,日時,ニチジ,ニチジ
ピックアップ	名詞,サ変接続,*,*,*,*,ピックアップ,ピックアップ,ピックアップ
プレーヤー	名詞,一般,*,*,*,*,プレーヤー,プレーヤー,プレーヤー
キリアン・ムバッペ	名詞,一般,*,*,*,*,*
パリ	名詞,固有名詞,地域,一般,*,*,パリ,パリ,パリ
サンジェルマン	名詞,固有名詞,組織,*,*,*,サンジェルマン,サンジェルマン,サンジェルマン
カーティス・ジョーンズ	名詞,一般,*,*,*,*,*
アンヘル・コレア	名詞,一般,*,*,*,*,*
アトレチコ・マドリッド	名詞,一般,*,*,*,*,*
ペドリ	名詞,一般,*,*,*,*,*
バルセロナ	名詞,固有名詞,地域,一般,*,*,バルセロナ,バルセロナ,バルセロナ
画像	名詞,一般,*,*,*,*,画像,ガゾウ,ガゾー
配信	名詞,サ変接続,*,*,*,*,配信,ハイシン,ハイシン
中	名詞,接尾,副詞可能,*,*,*,中,チュウ,チュー
チャンネル	名詞,一般,*,*,*,*,チャンネル,チャンネル,チャンネル
へ	助詞,格助詞,一般,*,*,*,へ,ヘ,エ
おすすめ	名詞,サ変接続,*,*,*,*,おすすめ,オススメ,オススメ
マンガ	名詞,一般,*,*,*,*,マンガ,マンガ,マンガ
得	名詞,一般,*,*,*,*,得,トク,トク
ホテル	名詞,一般,*,*,*,*,ホテル,ホテル,ホテル
旅館	名詞,一般,*,*,*,*,旅館,リョカン,リョカン
予約	名詞,サ変接続,*,*,*,*,予約,ヨヤク,ヨヤク
　	記号,空白,*,*,*,*,　,　,　
一休	名詞,固有名詞,人名,姓,*,*,一休,イッキュウ,イッキュー
レストラン	名詞,一般,*,*,*,*,レストラン,レストラン,レストラン
自動車	名詞,一般,*,*,*,*,自動車,ジドウシャ,ジドーシャ
国内	名詞,一般,*,*,*,*,国内,コクナイ,コクナイ
最大	名詞,一般,*,*,*,*,最大,サイダイ,サイダイ
級	名詞,接尾,一般,*,*,*,級,キュウ,キュー
無料	名詞,一般,*,*,*,*,無料,ムリョウ,ムリョー
料理	名詞,サ変接続,*,*,*,*,料理,リョウリ,リョーリ
レシピ	名詞,一般,*,*,*,*,レシピ,レシピ,レシピ
クラシル	名詞,一般,*,*,*,*,*
仕事	名詞,サ変接続,*,*,*,*,仕事,シゴト,シゴト
求人	名詞,サ変接続,*,*,*,*,求人,キュウジン,キュージン
探し	動詞,自立,*,*,五段・サ行,連用形,探す,サガシ,サガシ
スタンバイ	名詞,一般,*,*,*,*,スタンバイ,スタンバイ,スタンバイ
女性	名詞,一般,*,*,*,*,女性,ジョセイ,ジョセイ
向け	名詞,接尾,一般,*,*,*,向け,ムケ,ムケ
メディア	名詞,一般,*,*,*,*,メディア,メディア,メディア
」	記号,括弧閉,*,*,*,*,」,」,」
で	助動詞,*,*,*,特殊・ダ,連用形,だ,デ,デ
あり	助動詞,*,*,*,五段・ラ行アル,連用形,ある,アリ,アリ
ヤフー	名詞,固有名詞,組織,*,*,*,ヤフー,ヤフー,ヤフー
株式会社	名詞,一般,*,*,*,*,株式会社,カブシキガイシャ,カブシキガイシャ
と	助詞,格助詞,一般,*,*,*,と,ト,ト
協力	名詞,サ変接続,*,*,*,*,協力,キョウリョク,キョーリョク
運営	名詞,サ変接続,*,*,*,*,運営,ウンエイ,ウンエイ
プライバシー	名詞,一般,*,*,*,*,プライバシー,プライバシー,プライバシー
規約	名詞,一般,*,*,*,*,規約,キヤク,キヤク
会社	名詞,一般,*,*,*,*,会社,カイシャ,カイシャ
概要	名詞,一般,*,*,*,*,概要,ガイヨウ,ガイヨー
免責	名詞,サ変接続,*,*,*,*,免責,メンセキ,メンセキ
事項	名詞,一般,*,*,*,*,事項,ジコウ,ジコー
広告	名詞,サ変接続,*,*,*,*,広告,コウコク,コーコク
掲載	名詞,サ変接続,*,*,*,*,掲載,ケイサイ,ケイサイ
スタッフ	名詞,一般,*,*,*,*,スタッフ,スタッフ,スタッフ
募集	名詞,サ変接続,*,*,*,*,募集,ボシュウ,ボシュー
意見	名詞,サ変接続,*,*,*,*,意見,イケン,イケン
要望	名詞,サ変接続,*,*,*,*,要望,ヨウボウ,ヨーボー
問い合わせ	名詞,サ変接続,*,*,*,*,問い合わせ,トイアワセ,トイアワセ
日刊	名詞,一般,*,*,*,*,日刊,ニッカン,ニッカン
お気に入り	名詞,一般,*,*,*,*,お気に入り,オキニイリ,オキニイリ
行っ	動詞,自立,*,*,五段・カ行促音便,連用タ接続,行く,イッ,イッ
み	動詞,非自立,*,*,一段,連用形,みる,ミ,ミ
たい	助動詞,*,*,*,特殊・タイ,基本形,たい,タイ,タイ
旅行	名詞,サ変接続,*,*,*,*,旅行,リョコウ,リョコー
スター	名詞,一般,*,*,*,*,スター,スター,スター
付き	名詞,接尾,一般,*,*,*,付き,ツキ,ツキ
写真	名詞,一般,*,*,*,*,写真,シャシン,シャシン
長い	形容詞,自立,*,*,形容詞・アウオ段,基本形,長い,ナガイ,ナガイ
地中海	名詞,固有名詞,地域,一般,*,*,地中海,チチュウカイ,チチューカイ
海岸	名詞,一般,*,*,*,*,海岸,カイガン,カイガン
線	名詞,接尾,一般,*,*,*,線,セン,セン
持つ	動詞,自立,*,*,五段・タ行,基本形,持つ,モツ,モツ
ヨーロッパ	名詞,固有名詞,地域,一般,*,*,ヨーロッパ,ヨーロッパ,ヨーロッパ
国	名詞,一般,*,*,*,*,国,クニ,クニ
西洋	名詞,一般,*,*,*,*,西洋,セイヨウ,セイヨー
文化	名詞,一般,*,*,*,*,文化,ブンカ,ブンカ
大きな	連体詞,*,*,*,*,*,大きな,オオキナ,オーキナ
影響	名詞,サ変接続,*,*,*,*,影響,エイキョウ,エイキョー
与え	動詞,自立,*,*,一段,連用形,与える,アタエ,アタエ
首都	名詞,一般,*,*,*,*,首都,シュト,シュト
ローマ	名詞,固有名詞,地域,一般,*,*,ローマ,ローマ,ローマ
バチカン	名詞,固有名詞,地域,一般,*,*,バチカン,バチカン,バチカン
市	名詞,接尾,地域,*,*,*,市,シ,シ
国	名詞,接尾,一般,*,*,*,国,コク,コク
名高い	形容詞,自立,*,*,形容詞・アウオ段,基本形,名高い,ナダカイ,ナダカイ
芸術	名詞,一般,*,*,*,*,芸術,ゲイジュツ,ゲイジュツ
作品	名詞,一般,*,*,*,*,作品,サクヒン,サクヒン
古代	名詞,一般,*,*,*,*,古代,コダイ,コダイ
遺跡	名詞,一般,*,*,*,*,遺跡,イセキ,イセキ
数々	名詞,副詞可能,*,*,*,*,数々,カズカズ,カズカズ
知ら	動詞,自立,*,*,五段・ラ行,未然形,知る,シラ,シラ
れ	動詞,接尾,*,*,一段,連用形,れる,レ,レ
他	名詞,一般,*,*,*,*,他,タ,タ
主要	名詞,形容動詞語幹,*,*,*,*,主要,シュヨウ,シュヨー
都市	名詞,一般,*,*,*,*,都市,トシ,トシ
ミケランジェロ	名詞,固有名詞,人名,姓,*,*,ミケランジェロ,ミケランジェロ,ミケランジェロ
ダビデ	名詞,一般,*,*,*,*,*
像	名詞,接尾,一般,*,*,*,像,ゾウ,ゾー
ブルネレスキ	名詞,一般,*,*,*,*,*
ドゥオーモ	名詞,一般,*,*,*,*,*
はじめ	名詞,副詞可能,*,*,*,*,はじめ,ハジメ,ハジメ
た	助動詞,*,*,*,特殊・タ,基本形,た,タ,タ
ルネッサンス	名詞,一般,*,*,*,*,ルネッサンス,ルネッサンス,ルネッサンス
傑作	名詞,一般,*,*,*,*,傑作,ケッサク,ケッサク
フィレンツェ	名詞,固有名詞,地域,一般,*,*,フィレンツェ,フィレンツェ,フィレンツェ
運河	名詞,一般,*,*,*,*,運河,ウンガ,ウンガ
街	名詞,一般,*,*,*,*,街,マチ,マチ
ベネチア	名詞,固有名詞,地域,一般,*,*,ベネチア,ベネチア,ベネチア
ファッション	名詞,一般,*,*,*,*,ファッション,ファッション,ファッション
中心	名詞,一般,*,*,*,*,中心,チュウシン,チューシン
地	名詞,接尾,一般,*,*,*,地,チ,チ
ミラノ	名詞,固有名詞,地域,一般,*,*,ミラノ,ミラノ,ミラノ
語	名詞,接尾,一般,*,*,*,語,ゴ,ゴ
美	名詞,接尾,一般,*,*,*,美,ビ,ビ
海	名詞,一般,*,*,*,*,海,ウミ,ウミ
食品	名詞,一般,*,*,*,*,食品,ショクヒン,ショクヒン
アート	名詞,一般,*,*,*,*,アート,アート,アート
電車	名詞,一般,*,*,*,*,電車,デンシャ,デンシャ
おしゃれ	名詞,サ変接続,*,*,*,*,おしゃれ,オシャレ,オシャレ
撮影	名詞,サ変接続,*,*,*,*,撮影,サツエイ,サツエイ
日	名詞,接尾,助数詞,*,*,*,日,ニチ,ニチ
前	名詞,副詞可能,*,*,*,*,前,マエ,マエ
山	名詞,接尾,地域,*,*,*,山,サン,サン
中央	名詞,一般,*,*,*,*,中央,チュウオウ,チューオー
標準時	名詞,一般,*,*,*,*,標準時,ヒョウジュンジ,ヒョージュンジ
夏時間	名詞,一般,*,*,*,*,夏時間,ナツジカン,ナツジカン
月	名詞,一般,*,*,*,*,月,ツキ,ツキ
外部	名詞,一般,*,*,*,*,外部,ガイブ,ガイブ
リンク	名詞,サ変接続,*,*,*,*,リンク,リンク,リンク
切れ	名詞,接尾,一般,*,*,*,切れ,ギレ,ギレ
なっ	動詞,自立,*,*,五段・ラ行,連用タ接続,なる,ナッ,ナッ
いる	動詞,非自立,*,*,一段,基本形,いる,イル,イル
記事	名詞,一般,*,*,*,*,記事,キジ,キジ
年	名詞,接尾,助数詞,*,*,*,年,ネン,ネン
書き	名詞,接尾,一般,*,*,*,書き,ガキ,ガキ
かけ	名詞,非自立,一般,*,*,*,かけ,カケ,カケ
節	名詞,一般,*,*,*,*,節,フシ,フシ
の	助詞,格助詞,一般,*,*,*,の,ノ,ノ
項目	名詞,一般,*,*,*,*,項目,コウモク,コーモク
識別子	名詞,一般,*,*,*,*,識別子,シキベツシ,シキベツシ
指定	名詞,サ変接続,*,*,*,*,指定,シテイ,シテイ
加盟	名詞,サ変接続,*,*,*,*,加盟,カメイ,カメイ
連合	名詞,サ変接続,*,*,*,*,連合,レンゴウ,レンゴー
共和	名詞,一般,*,*,*,*,共和,キョウワ,キョーワ
圏	名詞,接尾,一般,*,*,*,圏,ケン,ケン
金融	名詞,一般,*,*,*,*,金融,キンユウ,キンユー
スキャンダル	名詞,一般,*,*,*,*,スキャンダル,スキャンダル,スキャンダル
国際	名詞,一般,*,*,*,*,国際,コクサイ,コクサイ
編集	名詞,サ変接続,*,*,*,*,編集,ヘンシュウ,ヘンシュー
出典	名詞,一般,*,*,*,*,出典,シュッテン,シュッテン
フリー	名詞,一般,*,*,*,*,フリー,フリー,フリー
百科	名詞,一般,*,*,*,*,百科,ヒャッカ,ヒャッカ
事典	名詞,一般,*,*,*,*,事典,ジテン,ジテン
『	記号,括弧開,*,*,*,*,『,『,『
ウィキペディア	名詞,一般,*,*,*,*,*
ナビゲーション	名詞,一般,*,*,*,*,*
移動	名詞,サ変接続,*,*,*,*,移動,イドウ,イドー
曖昧	名詞,形容動詞語幹,*,*,*,*,曖昧,アイマイ,アイマイ
さ	名詞,接尾,特殊,*,*,*,さ,サ,サ
回避	名詞,サ変接続,*,*,*,*,回避,カイヒ,カイヒ
以後	名詞,接尾,副詞可能,*,*,*,以後,イゴ,イゴ
説明	名詞,サ変接続,*,*,*,*,説明,セツメイ,セツメイ
世紀	名詞,一般,*,*,*,*,世紀,セイキ,セイキ
存在	名詞,サ変接続,*,*,*,*,存在,ソンザイ,ソンザイ
半島	名詞,一般,*,*,*,*,半島,ハントウ,ハントー
国家	名詞,一般,*,*,*,*,国家,コッカ,コッカ
伊	名詞,固有名詞,地域,国,*,*,伊,イ,イ
リダイレクト	名詞,一般,*,*,*,*,*
転送	名詞,サ変接続,*,*,*,*,転送,テンソウ,テンソー
漢	名詞,固有名詞,地域,国,*,*,漢,カン,カン
姓	名詞,一般,*,*,*,*,姓,セイ,セイ
国旗	名詞,一般,*,*,*,*,国旗,コッキ,コッキ
章	名詞,固有名詞,人名,名,*,*,章,アキラ,アキラ
標語	名詞,一般,*,*,*,*,標語,ヒョウゴ,ヒョーゴ
：	記号,一般,*,*,*,*,：,：,：
特に	副詞,一般,*,*,*,*,特に,トクニ,トクニ
なし	形容詞,自立,*,*,形容詞・アウオ段,文語基本形,ない,ナシ,ナシ
国歌	名詞,一般,*,*,*,*,国歌,コッカ,コッカ
マメーリ	名詞,一般,*,*,*,*,*
賛歌	名詞,一般,*,*,*,*,賛歌,サンカ,サンカ
人	名詞,接尾,一般,*,*,*,人,ジン,ジン
達	名詞,接尾,一般,*,*,*,達,タチ,タチ
唱歌	名詞,一般,*,*,*,*,唱歌,ショウカ,ショーカ
オリジナル	名詞,一般,*,*,*,*,オリジナル,オリジナル,オリジナル
ファイル	名詞,一般,*,*,*,*,ファイル,ファイル,ファイル
ソース	名詞,一般,*,*,*,*,ソース,ソース,ソース
한국어	記号,一般,*,*,*,*,*
文	名詞,一般,*,*,*,*,文,ブン,ブン
繁	名詞,固有名詞,人名,名,*,*,繁,シゲル,シゲル
體	名詞,固有名詞,組織,*,*,*,*
位置	名詞,サ変接続,*,*,*,*,位置,イチ,イチ
公用	名詞,一般,*,*,*,*,公用,コウヨウ,コーヨー
注釈	名詞,サ変接続,*,*,*,*,注釈,チュウシャク,チューシャク
政府	名詞,一般,*,*,*,*,政府,セイフ,セイフ
大統領	名詞,一般,*,*,*,*,大統領,ダイトウリョウ,ダイトーリョー
セルジョ・マッタレッラ	名詞,一般,*,*,*,*,*
閣僚	名詞,一般,*,*,*,*,閣僚,カクリョウ,カクリョー
評議	名詞,サ変接続,*,*,*,*,評議,ヒョウギ,ヒョーギ
会	名詞,接尾,一般,*,*,*,会,カイ,カイ
議長	名詞,一般,*,*,*,*,議長,ギチョウ,ギチョー
マリオ・ドラギ	名詞,一般,*,*,*,*,*
元老	名詞,一般,*,*,*,*,元老,ゲンロウ,ゲンロー
院	名詞,接尾,一般,*,*,*,院,イン,イン
エリザベッタ・カゼッラティ	名詞,一般,*,*,*,*,*
代議	名詞,サ変接続,*,*,*,*,代議,ダイギ,ダイギ
ロベルト・フィコ	名詞,一般,*,*,*,*,*
面積	名詞,一般,*,*,*,*,面積,メンセキ,メンセキ
総計	名詞,サ変接続,*,*,*,*,総計,ソウケイ,ソーケイ
平方キロメートル	名詞,一般,*,*,*,*,平方キロメートル,ヘイホウキロメートル,ヘイホーキロメートル
順	名詞,接尾,一般,*,*,*,順,ジュン,ジュン
リスト	名詞,一般,*,*,*,*,リスト,リスト,リスト
位	名詞,接尾,助数詞,*,*,*,位,イ,イ
水	名詞,接尾,一般,*,*,*,水,スイ,スイ
率	名詞,接尾,一般,*,*,*,率,リツ,リツ
人口	名詞,一般,*,*,*,*,人口,ジンコウ,ジンコー
密度	名詞,一般,*,*,*,*,密度,ミツド,ミツド
総	接頭詞,名詞接続,*,*,*,*,総,ソウ,ソー
生産	名詞,サ変接続,*,*,*,*,生産,セイサン,セイサン
自国	名詞,一般,*,*,*,*,自国,ジコク,ジコク
通貨	名詞,一般,*,*,*,*,通貨,ツウカ,ツーカ
合計	名詞,サ変接続,*,*,*,*,合計,ゴウケイ,ゴーケイ
兆	名詞,数,*,*,*,*,兆,チョウ,チョー
億	名詞,数,*,*,*,*,億,オク,オク
万	名詞,数,*,*,*,*,万,マン,マン
ユーロ	名詞,一般,*,*,*,*,ユーロ,ユーロ,ユーロ
為替	名詞,一般,*,*,*,*,為替,カワセ,カワセ
レート	名詞,一般,*,*,*,*,レート,レート,レート
ドル	名詞,一般,*,*,*,*,ドル,ドル,ドル
各国	名詞,一般,*,*,*,*,各国,カッコク,カッコク
名目	名詞,一般,*,*,*,*,名目,メイモク,メイモク
人	名詞,接尾,助数詞,*,*,*,人,ニン,ニン
あたり	名詞,接尾,一般,*,*,*,あたり,アタリ,アタリ
購買	名詞,サ変接続,*,*,*,*,購買,コウバイ,コーバイ
力	名詞,接尾,一般,*,*,*,力,リョク,リョク
平価	名詞,一般,*,*,*,*,平価,ヘイカ,ヘイカ
説	名詞,接尾,一般,*,*,*,説,セツ,セツ
実質	名詞,一般,*,*,*,*,実質,ジッシツ,ジッシツ
成立	名詞,サ変接続,*,*,*,*,成立,セイリツ,セイリツ
統一	名詞,サ変接続,*,*,*,*,統一,トウイツ,トーイツ
運動	名詞,サ変接続,*,*,*,*,運動,ウンドウ,ウンドー
遷都	名詞,サ変接続,*,*,*,*,遷都,セント,セント
ファシスト	名詞,一般,*,*,*,*,ファシスト,ファシスト,ファシスト
政権	名詞,一般,*,*,*,*,政権,セイケン,セイケン
王政	名詞,一般,*,*,*,*,王政,オウセイ,オーセイ
廃止	名詞,サ変接続,*,*,*,*,廃止,ハイシ,ハイシ
に関する	助詞,格助詞,連語,*,*,*,に関する,ニカンスル,ニカンスル
国民	名詞,一般,*,*,*,*,国民,コクミン,コクミン
投票	名詞,サ変接続,*,*,*,*,投票,トウヒョウ,トーヒョー
制	名詞,接尾,一般,*,*,*,制,セイ,セイ
移行	名詞,サ変接続,*,*,*,*,移行,イコウ,イコー
帯	名詞,接尾,一般,*,*,*,帯,タイ,タイ
協定	名詞,サ変接続,*,*,*,*,協定,キョウテイ,キョーテイ
時	名詞,接尾,副詞可能,*,*,*,時,ジ,ジ
別	名詞,接尾,一般,*,*,*,別,ベツ,ベツ
コードトップレベルドメイン	名詞,一般,*,*,*,*,*
電話	名詞,サ変接続,*,*,*,*,電話,デンワ,デンワ
番号	名詞,一般,*,*,*,*,番号,バンゴウ,バンゴー
国連	名詞,固有名詞,組織,*,*,*,国連,コクレン,コクレン
閲覧	名詞,サ変接続,*,*,*,*,閲覧,エツラン,エツラン
基金	名詞,一般,*,*,*,*,基金,キキン,キキン
きょう	名詞,副詞可能,*,*,*,*,きょう,キョウ,キョー
わ	助詞,終助詞,*,*,*,*,わ,ワ,ワ
こく	形容詞,自立,*,*,形容詞・アウオ段,連用テ接続,こい,コク,コク
通称	名詞,一般,*,*,*,*,通称,ツウショウ,ツーショー
音声	名詞,一般,*,*,*,*,音声,オンセイ,オンセイ
記号	名詞,一般,*,*,*,*,記号,キゴウ,キゴー
ˈ	記号,一般,*,*,*,*,*
ː	記号,一般,*,*,*,*,*
イターリャ	名詞,一般,*,*,*,*,*
南	名詞,一般,*,*,*,*,南,ミナミ,ミナミ
北	名詞,一般,*,*,*,*,北,キタ,キタ
スイス	名詞,固有名詞,地域,国,*,*,スイス,スイス,スイス
と	助詞,並立助詞,*,*,*,*,と,ト,ト
オーストリア	名詞,固有名詞,地域,国,*,*,オーストリア,オーストリア,オーストリア
西	名詞,一般,*,*,*,*,西,ニシ,ニシ
東	名詞,一般,*,*,*,*,東,ヒガシ,ヒガシ
スロベニア	名詞,固有名詞,地域,国,*,*,スロベニア,スロベニア,スロベニア
国境	名詞,一般,*,*,*,*,国境,コッキョウ,コッキョー
接し	動詞,自立,*,*,五段・サ行,連用形,接す,セッシ,セッシ
おり	動詞,非自立,*,*,五段・ラ行,連用形,おる,オリ,オリ
アルバニア	名詞,固有名詞,地域,国,*,*,アルバニア,アルバニア,アルバニア
アルジェリア	名詞,固有名詞,地域,国,*,*,アルジェリア,アルジェリア,アルジェリア
クロアチア	名詞,固有名詞,地域,国,*,*,クロアチア,クロアチア,クロアチア
ギリシャ	名詞,固有名詞,地域,国,*,*,ギリシャ,ギリシャ,ギリシャ
リビア	名詞,固有名詞,地域,国,*,*,リビア,リビア,リビア
マルタ	名詞,固有名詞,地域,国,*,*,マルタ,マルタ,マルタ
モンテネグロ	名詞,固有名詞,地域,国,*,*,モンテネグロ,モンテネグロ,モンテネグロ
チュニジア	名詞,固有名詞,地域,国,*,*,チュニジア,チュニジア,チュニジア
先	名詞,接尾,一般,*,*,*,先,サキ,サキ
まだ	副詞,助詞類接続,*,*,*,*,まだ,マダ,マダ
執筆	名詞,サ変接続,*,*,*,*,執筆,シッピツ,シッピツ
言語	名詞,一般,*,*,*,*,言語,ゲンゴ,ゲンゴ
版	名詞,接尾,一般,*,*,*,版,バン,バン
翻訳	名詞,サ変接続,*,*,*,*,翻訳,ホンヤク,ホンヤク
望ま	動詞,自立,*,*,五段・マ行,未然形,望む,ノゾマ,ノゾマ
海上	名詞,一般,*,*,*,*,海上,カイジョウ,カイジョー
境界	名詞,一般,*,*,*,*,境界,キョウカイ,キョーカイ
し	動詞,自立,*,*,サ変・スル,未然形,する,シ,シ
ない	助動詞,*,*,*,特殊・ナイ,基本形,ない,ナイ,ナイ
英語	名詞,一般,*,*,*,*,英語,エイゴ,エイゴ
共有	名詞,サ変接続,*,*,*,*,共有,キョウユウ,キョーユー
また	接続詞,*,*,*,*,*,また,マタ,マタ
国土	名詞,一般,*,*,*,*,国土,コクド,コクド
独立	名詞,サ変接続,*,*,*,*,独立,ドクリツ,ドクリツ
として	助詞,格助詞,連語,*,*,*,として,トシテ,トシテ
ある	助動詞,*,*,*,五段・ラ行アル,基本形,ある,アル,アル
バチカン	名詞,固有名詞,地域,国,*,*,バチカン,バチカン,バチカン
サンマリノ	名詞,固有名詞,地域,国,*,*,サンマリノ,サンマリノ,サンマリノ
目次	名詞,一般,*,*,*,*,目次,モクジ,モクジ
国名	名詞,一般,*,*,*,*,国名,コクメイ,コクメイ
歴史	名詞,一般,*,*,*,*,歴史,レキシ,レキシ
以前	名詞,副詞可能,*,*,*,*,以前,イゼン,イゼン
期	名詞,接尾,一般,*,*,*,期,キ,キ
ローマ帝国	名詞,固有名詞,地域,国,*,*,ローマ帝国,ローマテイコク,ローマテイコク
分割	名詞,サ変接続,*,*,*,*,分割,ブンカツ,ブンカツ
以降	名詞,副詞可能,*,*,*,*,以降,イコウ,イコー
近	接頭詞,名詞接続,*,*,*,*,近,キン,キン
現代	名詞,一般,*,*,*,*,現代,ゲンダイ,ゲンダイ
王国	名詞,一般,*,*,*,*,王国,オウコク,オーコク
政治	名詞,一般,*,*,*,*,政治,セイジ,セイジ
行政	名詞,一般,*,*,*,*,行政,ギョウセイ,ギョーセイ
立法	名詞,一般,*,*,*,*,立法,リッポウ,リッポー
憲法	名詞,一般,*,*,*,*,憲法,ケンポウ,ケンポー
改革	名詞,サ変接続,*,*,*,*,改革,カイカク,カイカク
案	名詞,接尾,一般,*,*,*,案,アン,アン
否決	名詞,サ変接続,*,*,*,*,否決,ヒケツ,ヒケツ
緊急	名詞,形容動詞語幹,*,*,*,*,緊急,キンキュウ,キンキュー
財政	名詞,一般,*,*,*,*,財政,ザイセイ,ザイセイ
法案	名詞,一般,*,*,*,*,法案,ホウアン,ホーアン
可決	名詞,サ変接続,*,*,*,*,可決,カケツ,カケツ
政党	名詞,一般,*,*,*,*,政党,セイトウ,セイトー
司法	名詞,一般,*,*,*,*,司法,シホウ,シホー
関係	名詞,サ変接続,*,*,*,*,関係,カンケイ,カンケイ
軍事	名詞,一般,*,*,*,*,軍事,グンジ,グンジ
陸軍	名詞,一般,*,*,*,*,陸軍,リクグン,リクグン
海軍	名詞,一般,*,*,*,*,海軍,カイグン,カイグン
空軍	名詞,一般,*,*,*,*,空軍,クウグン,クーグン
カラビニエリ	名詞,一般,*,*,*,*,*
機関	名詞,一般,*,*,*,*,機関,キカン,キカン
地理	名詞,一般,*,*,*,*,地理,チリ,チリ
地方	名詞,一般,*,*,*,*,地方,チホウ,チホー
区分	名詞,サ変接続,*,*,*,*,区分,クブン,クブン
経済	名詞,一般,*,*,*,*,経済,ケイザイ,ケイザイ
戦後	名詞,副詞可能,*,*,*,*,戦後,センゴ,センゴ
史	名詞,接尾,一般,*,*,*,史,シ,シ
貿易	名詞,サ変接続,*,*,*,*,貿易,ボウエキ,ボーエキ
エネルギー	名詞,一般,*,*,*,*,エネルギー,エネルギー,エネルギー
南北	名詞,一般,*,*,*,*,南北,ナンボク,ナンボク
格差	名詞,一般,*,*,*,*,格差,カクサ,カクサ
花形	名詞,一般,*,*,*,*,花形,ハナガタ,ハナガタ
産業	名詞,一般,*,*,*,*,産業,サンギョウ,サンギョー
交通	名詞,一般,*,*,*,*,交通,コウツウ,コーツー
道路	名詞,一般,*,*,*,*,道路,ドウロ,ドーロ
鉄道	名詞,一般,*,*,*,*,鉄道,テツドウ,テツドー
海運	名詞,一般,*,*,*,*,海運,カイウン,カイウン
空	名詞,一般,*,*,*,*,空,ソラ,ソラ
運	名詞,一般,*,*,*,*,運,ウン,ウン
民族	名詞,一般,*,*,*,*,民族,ミンゾク,ミンゾク
少数	名詞,一般,*,*,*,*,少数,ショウスウ,ショースー
難民	名詞,一般,*,*,*,*,難民,ナンミン,ナンミン
方言	名詞,一般,*,*,*,*,方言,ホウゲン,ホーゲン
外国	名詞,一般,*,*,*,*,外国,ガイコク,ガイコク
婚姻	名詞,サ変接続,*,*,*,*,婚姻,コンイン,コンイン
宗教	名詞,一般,*,*,*,*,宗教,シュウキョウ,シューキョー
教育	名詞,サ変接続,*,*,*,*,教育,キョウイク,キョーイク
保健	名詞,一般,*,*,*,*,保健,ホケン,ホケン
医療	名詞,一般,*,*,*,*,医療,イリョウ,イリョー
治安	名詞,一般,*,*,*,*,治安,チアン,チアン
警察	名詞,一般,*,*,*,*,警察,ケイサツ,ケイサツ
マフィア	名詞,固有名詞,組織,*,*,*,マフィア,マフィア,マフィア
人権	名詞,一般,*,*,*,*,人権,ジンケン,ジンケン
マスコミ	名詞,一般,*,*,*,*,マスコミ,マスコミ,マスコミ
文学	名詞,一般,*,*,*,*,文学,ブンガク,ブンガク
哲学	名詞,一般,*,*,*,*,哲学,テツガク,テツガク
音楽	名詞,一般,*,*,*,*,音楽,オンガク,オンガク
クラシック	名詞,一般,*,*,*,*,クラシック,クラシック,クラシック
ポピュラー	名詞,一般,*,*,*,*,ポピュラー,ポピュラー,ポピュラー
美術	名詞,一般,*,*,*,*,美術,ビジュツ,ビジュツ
映画	名詞,一般,*,*,*,*,映画,エイガ,エイガ
建築	名詞,サ変接続,*,*,*,*,建築,ケンチク,ケンチク
遺産	名詞,一般,*,*,*,*,遺産,イサン,イサン
祝祭日	名詞,一般,*,*,*,*,祝祭日,シュクサイジツ,シュクサイジツ
バスケットボール	名詞,一般,*,*,*,*,バスケットボール,バスケットボール,バスケットボール
モータースポーツ	名詞,一般,*,*,*,*,モータースポーツ,モータースポーツ,モータースポーツ
四	名詞,数,*,*,*,*,四,ヨン,ヨン
輪	名詞,接尾,助数詞,*,*,*,輪,リン,リン
二	名詞,数,*,*,*,*,二,ニ,ニ
自転車	名詞,一般,*,*,*,*,自転車,ジテンシャ,ジテンシャ
登山	名詞,サ変接続,*,*,*,*,登山,トザン,トザン
著名	名詞,形容動詞語幹,*,*,*,*,著名,チョメイ,チョメイ
な	助動詞,*,*,*,特殊・ダ,体言接続,だ,ナ,ナ
出身	名詞,一般,*,*,*,*,出身,シュッシン,シュッシン
参考	名詞,サ変接続,*,*,*,*,参考,サンコウ,サンコー
文献	名詞,一般,*,*,*,*,文献,ブンケン,ブンケン
脚注	名詞,一般,*,*,*,*,脚注,キャクチュウ,キャクチュー
関連	名詞,サ変接続,*,*,*,*,関連,カンレン,カンレン
節	名詞,接尾,一般,*,*,*,節,ブシ,ブシ
拡大	名詞,サ変接続,*,*,*,*,拡大,カクダイ,カクダイ
上空	名詞,一般,*,*,*,*,上空,ジョウクウ,ジョークー
衛星	名詞,一般,*,*,*,*,衛星,エイセイ,エイセイ
における	助詞,格助詞,連語,*,*,*,における,ニオケル,ニオケル
発祥	名詞,サ変接続,*,*,*,*,発祥,ハッショウ,ハッショー
一つ	名詞,一般,*,*,*,*,一つ,ヒトツ,ヒトツ
同時に	副詞,一般,*,*,*,*,同時に,ドウジニ,ドージニ
的	名詞,接尾,形容動詞語幹,*,*,*,的,テキ,テキ
大国	名詞,一般,*,*,*,*,大国,タイコク,タイコク
一	名詞,数,*,*,*,*,一,イチ,イチ
数え	動詞,自立,*,*,一段,未然形,数える,カゾエ,カゾエ
られ	動詞,接尾,*,*,一段,連用形,られる,ラレ,ラレ
学問	名詞,サ変接続,*,*,*,*,学問,ガクモン,ガクモン
発揮	名詞,サ変接続,*,*,*,*,発揮,ハッキ,ハッキ
領域	名詞,一般,*,*,*,*,領域,リョウイキ,リョーイキ
内	名詞,接尾,一般,*,*,*,内,ナイ,ナイ
事実	名詞,副詞可能,*,*,*,*,事実,ジジツ,ジジツ
上	名詞,接尾,副詞可能,*,*,*,上,ジョウ,ジョー
保護	名詞,サ変接続,*,*,*,*,保護,ホゴ,ホゴ
レオナルド・ダ・ヴィンチ	名詞,一般,*,*,*,*,*
ガリ	名詞,固有名詞,人名,姓,*,*,ガリ,ガリ,ガリ
レオ	名詞,固有名詞,人名,名,*,*,レオ,レオ,レオ
レイ	名詞,固有名詞,人名,名,*,*,レイ,レイ,レイ
ミケランジェロ・ブオナローティ	名詞,一般,*,*,*,*,*
クリストファー	名詞,固有名詞,人名,名,*,*,クリストファー,クリストファー,クリストファー
コロンブス	名詞,固有名詞,人名,姓,*,*,コロンブス,コロンブス,コロンブス
ニッコロ・マキャヴェッリ	名詞,一般,*,*,*,*,*
マキャヴェリ	名詞,一般,*,*,*,*,*
といった	助詞,格助詞,連語,*,*,*,といった,トイッタ,トイッタ
偉人	名詞,一般,*,*,*,*,偉人,イジン,イジン
たち	名詞,接尾,一般,*,*,*,たち,タチ,タチ
故国	名詞,一般,*,*,*,*,故国,ココク,ココク
かつて	副詞,一般,*,*,*,*,かつて,カツテ,カツテ
中枢	名詞,一般,*,*,*,*,中枢,チュウスウ,チュースー
なる	動詞,自立,*,*,五段・ラ行,基本形,なる,ナル,ナル
ルネサンス	名詞,一般,*,*,*,*,ルネサンス,ルネサンス,ルネサンス
リソルジメント	名詞,一般,*,*,*,*,*
幾つ	名詞,一般,*,*,*,*,幾つ,イクツ,イクツ
か	助詞,副助詞／並立助詞／終助詞,*,*,*,*,か,カ,カ
事象	名詞,一般,*,*,*,*,事象,ジショウ,ジショー
舞台	名詞,一般,*,*,*,*,舞台,ブタイ,ブタイ
高い	形容詞,自立,*,*,形容詞・アウオ段,基本形,高い,タカイ,タカイ
人間	名詞,一般,*,*,*,*,人間,ニンゲン,ニンゲン
開発	名詞,サ変接続,*,*,*,*,開発,カイハツ,カイハツ
指数	名詞,一般,*,*,*,*,指数,シスウ,シスー
による	助詞,格助詞,連語,*,*,*,による,ニヨル,ニヨル
とも	名詞,接尾,一般,*,*,*,とも,トモ,トモ
先進	名詞,一般,*,*,*,*,先進,センシン,センシン
第	接頭詞,数接続,*,*,*,*,第,ダイ,ダイ
かつ	接続詞,*,*,*,*,*,かつ,カツ,カツ
それ	名詞,代名詞,一般,*,*,*,それ,ソレ,ソレ
補正	名詞,サ変接続,*,*,*,*,補正,ホセイ,ホセイ
もの	名詞,非自立,一般,*,*,*,もの,モノ,モノ
次ぐ	動詞,自立,*,*,五段・ガ行,基本形,次ぐ,ツグ,ツグ
規模	名詞,一般,*,*,*,*,規模,キボ,キボ
北大西洋	名詞,固有名詞,地域,一般,*,*,北大西洋,キタタイセイヨウ,キタタイセイヨー
条約	名詞,一般,*,*,*,*,条約,ジョウヤク,ジョーヤク
機構	名詞,一般,*,*,*,*,機構,キコウ,キコー
一員	名詞,一般,*,*,*,*,一員,イチイン,イチイン
ビッグ	名詞,一般,*,*,*,*,ビッグ,ビッグ,ビッグ
及ぼす	動詞,自立,*,*,五段・サ行,基本形,及ぼす,オヨボス,オヨボス
列強	名詞,一般,*,*,*,*,列強,レッキョウ,レッキョー
一角	名詞,一般,*,*,*,*,一角,イッカク,イッカク
られる	動詞,接尾,*,*,一段,基本形,られる,ラレル,ラレル
コンセンサス	名詞,一般,*,*,*,*,コンセンサス,コンセンサス,コンセンサス
参加	名詞,サ変接続,*,*,*,*,参加,サンカ,サンカ
と	助詞,格助詞,引用,*,*,*,と,ト,ト
主導	名詞,サ変接続,*,*,*,*,主導,シュドウ,シュドー
面	名詞,接尾,一般,*,*,*,面,メン,メン
軍隊	名詞,一般,*,*,*,*,軍隊,グンタイ,グンタイ
有し	動詞,自立,*,*,五段・サ行,連用形,有す,ユウシ,ユーシ
ロ・スティヴァレ	名詞,一般,*,*,*,*,*
称さ	動詞,自立,*,*,五段・サ行,未然形,称す,ショウサ,ショーサ
突き出	動詞,自立,*,*,一段,連用形,突き出る,ツキデ,ツキデ
ブーツ	名詞,一般,*,*,*,*,ブーツ,ブーツ,ブーツ
状	名詞,接尾,一般,*,*,*,状,ジョウ,ジョー
浮かぶ	動詞,自立,*,*,五段・バ行,基本形,浮かぶ,ウカブ,ウカブ
シチリア	名詞,固有名詞,地域,一般,*,*,シチリア,シチリア,シチリア
島	名詞,接尾,地域,*,*,*,島,トウ,トー
サルデーニャ	名詞,一般,*,*,*,*,*
サルディーニャ	名詞,固有名詞,地域,一般,*,*,*
領土	名詞,一般,*,*,*,*,領土,リョウド,リョード
いくつ	名詞,代名詞,一般,*,*,*,いくつ,イクツ,イクツ
小島	名詞,固有名詞,人名,姓,*,*,小島,コジマ,コジマ
領有	名詞,サ変接続,*,*,*,*,領有,リョウユウ,リョーユー
北部	名詞,一般,*,*,*,*,北部,ホクブ,ホクブ
アルプス山脈	名詞,固有名詞,一般,*,*,*,アルプス山脈,アルプスサンミャク,アルプスサンミャク
沿っ	動詞,自立,*,*,五段・ワ行促音便,連用タ接続,沿う,ソッ,ソッ
アペニン	名詞,一般,*,*,*,*,*
山脈	名詞,一般,*,*,*,*,山脈,サンミャク,サンミャク
走っ	動詞,自立,*,*,五段・ラ行,連用タ接続,走る,ハシッ,ハシッ
平野	名詞,一般,*,*,*,*,平野,ヘイヤ,ヘイヤ
その間	名詞,副詞可能,*,*,*,*,その間,ソノカン,ソノカン
ポー	名詞,固有名詞,地域,一般,*,*,ポー,ポー,ポー
平原	名詞,一般,*,*,*,*,平原,ヘイゲン,ヘイゲン
限ら	動詞,自立,*,*,五段・ラ行,未然形,限る,カギラ,カギラ
％	名詞,接尾,助数詞,*,*,*,％,パーセント,パーセント
山岳	名詞,一般,*,*,*,*,山岳,サンガク,サンガク
地帯	名詞,一般,*,*,*,*,地帯,チタイ,チタイ
気候	名詞,一般,*,*,*,*,気候,キコウ,キコー
各地	名詞,一般,*,*,*,*,各地,カクチ,カクチ
温暖	名詞,形容動詞語幹,*,*,*,*,温暖,オンダン,オンダン
除き	動詞,自立,*,*,五段・カ行イ音便,連用形,除く,ノゾキ,ノゾキ
大	接頭詞,名詞接続,*,*,*,*,大,ダイ,ダイ
部分	名詞,一般,*,*,*,*,部分,ブブン,ブブン
温帯	名詞,一般,*,*,*,*,温帯,オンタイ,オンタイ
性	名詞,接尾,一般,*,*,*,性,セイ,セイ
属し	動詞,自立,*,*,五段・サ行,連用形,属す,ゾクシ,ゾクシ
これ	名詞,代名詞,一般,*,*,*,これ,コレ,コレ
農業	名詞,一般,*,*,*,*,農業,ノウギョウ,ノーギョー
き	動詞,非自立,*,*,カ変・クル,連用形,くる,キ,キ
港	名詞,一般,*,*,*,*,港,ミナト,ミナト
適し	動詞,自立,*,*,五段・サ行,連用形,適す,テキシ,テキシ
リグリア	名詞,一般,*,*,*,*,*
大陸棚	名詞,一般,*,*,*,*,大陸棚,タイリクダナ,タイリクダナ
幸	名詞,一般,*,*,*,*,幸,コウ,コー
豊富	名詞,形容動詞語幹,*,*,*,*,豊富,ホウフ,ホーフ
もたらす	動詞,自立,*,*,五段・サ行,基本形,もたらす,モタラス,モタラス
アドリア海	名詞,固有名詞,地域,一般,*,*,アドリア海,アドリアカイ,アドリアカイ
南東	名詞,一般,*,*,*,*,南東,ナントウ,ナントー
部	名詞,接尾,一般,*,*,*,部,ブ,ブ
バルカン半島	名詞,固有名詞,一般,*,*,*,バルカン半島,バルカンハントウ,バルカンハントー
繋がる	動詞,自立,*,*,五段・ラ行,基本形,繋がる,ツナガル,ツナガル
イオニア	名詞,固有名詞,地域,一般,*,*,イオニア,イオニア,イオニア
海	名詞,接尾,地域,*,*,*,海,カイ,カイ
恵まれ	動詞,自立,*,*,一段,連用形,恵まれる,メグマレ,メグマレ
ティレニア	名詞,一般,*,*,*,*,*
周辺	名詞,一般,*,*,*,*,周辺,シュウヘン,シューヘン
ストロンボリ	名詞,固有名詞,地域,一般,*,*,*
ストロンボリ	名詞,一般,*,*,*,*,*
火山	名詞,一般,*,*,*,*,火山,カザン,カザン
ヴェスヴィオ	名詞,固有名詞,地域,一般,*,*,*
エトナ	名詞,固有名詞,地域,一般,*,*,*
集まっ	動詞,自立,*,*,五段・ラ行,連用タ接続,集まる,アツマッ,アツマッ
有数	名詞,一般,*,*,*,*,有数,ユウスウ,ユースー
地震	名詞,一般,*,*,*,*,地震,ジシン,ジシン
正式	名詞,形容動詞語幹,*,*,*,*,正式,セイシキ,セイシキ
名称	名詞,一般,*,*,*,*,名称,メイショウ,メイショー
レプッブリカ・イタリアーナ	名詞,一般,*,*,*,*,*
̪	記号,一般,*,*,*,*,*
̺	記号,一般,*,*,*,*,*
̯	記号,一般,*,*,*,*,*
イターリア	名詞,一般,*,*,*,*,*
表記	名詞,サ変接続,*,*,*,*,表記,ヒョウキ,ヒョーキ
イタリャン・リパブリク	名詞,一般,*,*,*,*,*
ˈɪ	記号,一般,*,*,*,*,*
ə	記号,一般,*,*,*,*,*
イタリ	名詞,一般,*,*,*,*,*
が	助詞,接続助詞,*,*,*,*,が,ガ,ガ
イタリヤ	名詞,一般,*,*,*,*,*
こと	名詞,非自立,一般,*,*,*,こと,コト,コト
古く	副詞,助詞類接続,*,*,*,*,古く,フルク,フルク
イタリー	名詞,固有名詞,地域,国,*,*,イタリー,イタリー,イタリー
とも	助詞,副助詞,*,*,*,*,とも,トモ,トモ
発音	名詞,サ変接続,*,*,*,*,発音,ハツオン,ハツオン
フランス語	名詞,一般,*,*,*,*,フランス語,フランスゴ,フランスゴ
近い	形容詞,自立,*,*,形容詞・アウオ段,基本形,近い,チカイ,チカイ
地名	名詞,一般,*,*,*,*,地名,チメイ,チメイ
および	接続詞,*,*,*,*,*,および,オヨビ,オヨビ
漢字	名詞,一般,*,*,*,*,漢字,カンジ,カンジ
当て字	名詞,一般,*,*,*,*,当て字,アテジ,アテジ
伊太利	名詞,固有名詞,地域,国,*,*,伊太利,イタリア,イタリア
亜	名詞,固有名詞,地域,一般,*,*,亜,ア,ア
以太	名詞,一般,*,*,*,*,*
利	名詞,一般,*,*,*,*,利,リ,リ
略さ	動詞,自立,*,*,五段・サ行,未然形,略す,リャクサ,リャクサ
由来	名詞,サ変接続,*,*,*,*,由来,ユライ,ユライ
定説	名詞,一般,*,*,*,*,定説,テイセツ,テイセツ
一般	名詞,一般,*,*,*,*,一般,イッパン,イッパン
説	名詞,一般,*,*,*,*,説,セツ,セツ
紀元前	名詞,副詞可能,*,*,*,*,紀元前,キゲンゼン,キゲンゼン
ごろ	名詞,接尾,副詞可能,*,*,*,ごろ,ゴロ,ゴロ
カラブリア	名詞,一般,*,*,*,*,*
子	名詞,一般,*,*,*,*,子,コ,コ
ウシ	名詞,一般,*,*,*,*,ウシ,ウシ,ウシ
ビタリ	名詞,固有名詞,一般,*,*,*,*
トーテム	名詞,一般,*,*,*,*,トーテム,トーテム,トーテム
崇拝	名詞,サ変接続,*,*,*,*,崇拝,スウハイ,スーハイ
原住民	名詞,一般,*,*,*,*,原住民,ゲンジュウミン,ゲンジューミン
いわ	動詞,自立,*,*,五段・ワ行促音便,未然形,いう,イワ,イワ
彼ら	名詞,代名詞,一般,*,*,*,彼ら,カレラ,カレラ
ビタリ	名詞,一般,*,*,*,*,*
呼ば	動詞,自立,*,*,五段・バ行,未然形,呼ぶ,ヨバ,ヨバ
その後	名詞,副詞可能,*,*,*,*,その後,ソノゴ,ソノゴ
変化	名詞,サ変接続,*,*,*,*,変化,ヘンカ,ヘンカ
その	連体詞,*,*,*,*,*,その,ソノ,ソノ
呼称	名詞,サ変接続,*,*,*,*,呼称,コショウ,コショー
受け継が	動詞,自立,*,*,五段・ガ行,未然形,受け継ぐ,ウケツガ,ウケツガ
住む	動詞,自立,*,*,五段・マ行,基本形,住む,スム,スム
人々	名詞,一般,*,*,*,*,人々,ヒトビト,ヒトビト
指す	動詞,自立,*,*,五段・サ行,基本形,指す,サス,サス
よう	名詞,非自立,助動詞語幹,*,*,*,よう,ヨウ,ヨー
中世	名詞,一般,*,*,*,*,中世,チュウセイ,チューセイ
伯爵	名詞,一般,*,*,*,*,伯爵,ハクシャク,ハクシャク
領	名詞,接尾,一般,*,*,*,領,リョウ,リョー
公爵	名詞,一般,*,*,*,*,公爵,コウシャク,コーシャク
なす	動詞,自立,*,*,五段・サ行,基本形,なす,ナス,ナス
なかっ	形容詞,自立,*,*,形容詞・アウオ段,連用タ接続,ない,ナカッ,ナカッ
最初	名詞,一般,*,*,*,*,最初,サイショ,サイショ
名	名詞,一般,*,*,*,*,名,ナ,ナ
使用	名詞,サ変接続,*,*,*,*,使用,シヨウ,シヨー
の	名詞,非自立,一般,*,*,*,の,ノ,ノ
ナポレオン	名詞,固有名詞,人名,一般,*,*,ナポレオン,ナポレオン,ナポレオン
支配	名詞,サ変接続,*,*,*,*,支配,シハイ,シハイ
時代	名詞,一般,*,*,*,*,時代,ジダイ,ジダイ
改変	名詞,サ変接続,*,*,*,*,改変,カイヘン,カイヘン
サボイア	名詞,一般,*,*,*,*,*
家	名詞,接尾,一般,*,*,*,家,カ,カ
によって	助詞,格助詞,連語,*,*,*,によって,ニヨッテ,ニヨッテ
ほぼ	副詞,一般,*,*,*,*,ほぼ,ホボ,ホボ
範囲	名詞,一般,*,*,*,*,範囲,ハンイ,ハンイ
もつ	動詞,自立,*,*,五段・タ行,基本形,もつ,モツ,モツ
参照	名詞,サ変接続,*,*,*,*,参照,サンショウ,サンショー
シリーズ	名詞,一般,*,*,*,*,シリーズ,シリーズ,シリーズ
一部	名詞,副詞可能,*,*,*,*,一部,イチブ,イチブ
エトルリア	名詞,一般,*,*,*,*,*
マグナ・グラエキア	名詞,一般,*,*,*,*,*
政	名詞,一般,*,*,*,*,政,セイ,セイ
ゴート	名詞,一般,*,*,*,*,*
ランゴバルド	名詞,一般,*,*,*,*,*
教皇	名詞,一般,*,*,*,*,教皇,キョウコウ,キョーコー
中部	名詞,一般,*,*,*,*,中部,チュウブ,チューブ
フランク	名詞,固有名詞,人名,名,*,*,フランク,フランク,フランク
イスラム	名詞,固有名詞,一般,*,*,*,イスラム,イスラム,イスラム
征服	名詞,サ変接続,*,*,*,*,征服,セイフク,セイフク
ノ	記号,一般,*,*,*,*,ノ,ノ,ノ
ルマン	名詞,固有名詞,地域,一般,*,*,ルマン,ルマン,ルマン
派	名詞,接尾,一般,*,*,*,派,ハ,ハ
皇帝	名詞,一般,*,*,*,*,皇帝,コウテイ,コーテイ
近世	名詞,一般,*,*,*,*,近世,キンセイ,キンセイ
年表	名詞,一般,*,*,*,*,年表,ネンピョウ,ネンピョー
戦争	名詞,サ変接続,*,*,*,*,戦争,センソウ,センソー
–	名詞,サ変接続,*,*,*,*,*
近代	名詞,一般,*,*,*,*,近代,キンダイ,キンダイ
戦線	名詞,一般,*,*,*,*,戦線,センセン,センセン
次	名詞,接尾,助数詞,*,*,*,次,ジ,ジ
大戦	名詞,一般,*,*,*,*,大戦,タイセン,タイセン
党	名詞,一般,*,*,*,*,党,トウ,トー
社会	名詞,一般,*,*,*,*,社会,シャカイ,シャカイ
鉛	名詞,一般,*,*,*,*,鉛,ナマリ,ナマリ
テーマ	名詞,一般,*,*,*,*,テーマ,テーマ,テーマ
遠征	名詞,サ変接続,*,*,*,*,遠征,エンセイ,エンセイ
絵画	名詞,一般,*,*,*,*,絵画,カイガ,カイガ
ポータル	名詞,一般,*,*,*,*,*
テンプレート	名詞,一般,*,*,*,*,テンプレート,テンプレート,テンプレート
表	名詞,接尾,一般,*,*,*,表,ヒョウ,ヒョー
‐	記号,一般,*,*,*,*,‐,‐,‐
ノート	名詞,一般,*,*,*,*,ノート,ノート,ノート
話	名詞,接尾,サ変接続,*,*,*,話,バナシ,バナシ
編	名詞,接尾,一般,*,*,*,編,ヘン,ヘン
ギリシア	名詞,固有名詞,地域,国,*,*,ギリシア,ギリシア,ギリシア
なお	接続詞,*,*,*,*,*,なお,ナオ,ナオ
伝説	名詞,一般,*,*,*,*,伝説,デンセツ,デンセツ
建国	名詞,サ変接続,*,*,*,*,建国,ケンコク,ケンコク
築い	動詞,自立,*,*,五段・カ行イ音便,連用タ接続,築く,キズイ,キズイ
伝承	名詞,サ変接続,*,*,*,*,伝承,デンショウ,デンショー
よれ	動詞,自立,*,*,五段・ラ行,仮定形,よる,ヨレ,ヨレ
ば	助詞,接続助詞,*,*,*,*,ば,バ,バ
パトリキ	名詞,一般,*,*,*,*,*
貴族	名詞,一般,*,*,*,*,貴族,キゾク,キゾク
王	名詞,一般,*,*,*,*,王,オウ,オー
追放	名詞,サ変接続,*,*,*,*,追放,ツイホウ,ツイホー
開始	名詞,サ変接続,*,*,*,*,開始,カイシ,カイシ
サムニウム	名詞,一般,*,*,*,*,*
により	助詞,格助詞,連語,*,*,*,により,ニヨリ,ニヨリ
制圧	名詞,サ変接続,*,*,*,*,制圧,セイアツ,セイアツ
フェニキア	名詞,一般,*,*,*,*,*
植民	名詞,サ変接続,*,*,*,*,植民,ショクミン,ショクミン
カルタゴ	名詞,固有名詞,地域,一般,*,*,カルタゴ,カルタゴ,カルタゴ
ポエニ	名詞,一般,*,*,*,*,*
獲得	名詞,サ変接続,*,*,*,*,獲得,カクトク,カクトク
覇権	名詞,一般,*,*,*,*,覇権,ハケン,ハケン
握る	動詞,自立,*,*,五段・ラ行,基本形,握る,ニギル,ニギル
栄え	動詞,自立,*,*,一段,連用形,栄える,サカエ,サカエ
ディオクレティアヌス	名詞,一般,*,*,*,*,*
帝国	名詞,一般,*,*,*,*,帝国,テイコク,テイコク
統治	名詞,サ変接続,*,*,*,*,統治,トウチ,トーチ
位	名詞,接尾,一般,*,*,*,位,イ,イ
東西	名詞,一般,*,*,*,*,東西,トウザイ,トーザイ
テトラルキア	名詞,一般,*,*,*,*,*
権	名詞,接尾,一般,*,*,*,権,ケン,ケン
西方	名詞,固有名詞,人名,姓,*,*,西方,ニシカタ,ニシカタ
正	名詞,固有名詞,人名,名,*,*,正,タダシ,タダシ
帝	名詞,一般,*,*,*,*,帝,ミカド,ミカド
管轄	名詞,サ変接続,*,*,*,*,管轄,カンカツ,カンカツ
末	名詞,接尾,副詞可能,*,*,*,末,マツ,マツ
と	助詞,接続助詞,*,*,*,*,と,ト,ト
ゼノン	名詞,一般,*,*,*,*,*
オドアケル	名詞,一般,*,*,*,*,*
領主	名詞,一般,*,*,*,*,領主,リョウシュ,リョーシュ
任命	名詞,サ変接続,*,*,*,*,任命,ニンメイ,ニンメイ
国号	名詞,一般,*,*,*,*,国号,コクゴウ,コクゴー
走り	名詞,一般,*,*,*,*,走り,ハシリ,ハシリ
紀元	名詞,一般,*,*,*,*,紀元,キゲン,キゲン
版図	名詞,一般,*,*,*,*,版図,ハント,ハント
茶	名詞,一般,*,*,*,*,茶,チャ,チャ
緑	名詞,一般,*,*,*,*,緑,ミドリ,ミドリ
滅ぼさ	動詞,自立,*,*,五段・サ行,未然形,滅ぼす,ホロボサ,ホロボサ
あと	名詞,一般,*,*,*,*,あと,アト,アト
アナスタシウス	名詞,一般,*,*,*,*,*
世	名詞,接尾,助数詞,*,*,*,世,セイ,セイ
テオドリック	名詞,一般,*,*,*,*,*
王	名詞,接尾,一般,*,*,*,王,オウ,オー
授け	動詞,自立,*,*,一段,未然形,授ける,サヅケ,サズケ
設立	名詞,サ変接続,*,*,*,*,設立,セツリツ,セツリツ
ぶり	名詞,接尾,一般,*,*,*,ぶり,ブリ,ブリ
しかし	接続詞,*,*,*,*,*,しかし,シカシ,シカシ
にとって	助詞,格助詞,連語,*,*,*,にとって,ニトッテ,ニトッテ
もはや	副詞,助詞類接続,*,*,*,*,もはや,モハヤ,モハヤ
属	名詞,サ変接続,*,*,*,*,属,ゾク,ゾク
州	名詞,接尾,地域,*,*,*,州,シュウ,シュー
すぎ	動詞,自立,*,*,一段,未然形,すぎる,スギ,スギ
さらに	副詞,助詞類接続,*,*,*,*,さらに,サラニ,サラニ
侵入	名詞,サ変接続,*,*,*,*,侵入,シンニュウ,シンニュー
に対する	助詞,格助詞,連語,*,*,*,に対する,ニタイスル,ニタイスル
大きく	形容詞,自立,*,*,形容詞・イ段,連用テ接続,大きい,オオキク,オーキク
低下	名詞,サ変接続,*,*,*,*,低下,テイカ,テイカ
常駐	名詞,サ変接続,*,*,*,*,常駐,ジョウチュウ,ジョーチュー
最後	名詞,一般,*,*,*,*,最後,サイゴ,サイゴ
コンス	名詞,一般,*,*,*,*,コンス,コンス,コンス
タンス	名詞,一般,*,*,*,*,タンス,タンス,タンス
彼	名詞,代名詞,一般,*,*,*,彼,カレ,カレ
アフリカ	名詞,固有名詞,地域,一般,*,*,アフリカ,アフリカ,アフリカ
再	接頭詞,名詞接続,*,*,*,*,再,サイ,サイ
編成	名詞,サ変接続,*,*,*,*,編成,ヘンセイ,ヘンセイ
しよ	動詞,自立,*,*,サ変・スル,未然ウ接続,する,シヨ,シヨ
う	助動詞,*,*,*,不変化型,基本形,う,ウ,ウ
意図	名詞,サ変接続,*,*,*,*,意図,イト,イト
失敗	名詞,サ変接続,*,*,*,*,失敗,シッパイ,シッパイ
終わっ	動詞,自立,*,*,五段・ラ行,連用タ接続,終わる,オワッ,オワッ
勢力	名詞,一般,*,*,*,*,勢力,セイリョク,セイリョク
南端	名詞,一般,*,*,*,*,南端,ナンタン,ナンタン
まで	助詞,副助詞,*,*,*,*,まで,マデ,マデ
後退	名詞,サ変接続,*,*,*,*,後退,コウタイ,コータイ
教徒	名詞,一般,*,*,*,*,教徒,キョウト,キョート
神聖	名詞,一般,*,*,*,*,神聖,シンセイ,シンセイ
割拠	名詞,サ変接続,*,*,*,*,割拠,カッキョ,カッキョ
ほか	名詞,副詞可能,*,*,*,*,ほか,ホカ,ホカ
多数	名詞,副詞可能,*,*,*,*,多数,タスウ,タスー
発展	名詞,サ変接続,*,*,*,*,発展,ハッテン,ハッテン
代わり	動詞,自立,*,*,五段・ラ行,連用形,代わる,カワリ,カワリ
これら	名詞,代名詞,一般,*,*,*,これら,コレラ,コレラ
中	名詞,非自立,副詞可能,*,*,*,中,ナカ,ナカ
試みる	動詞,自立,*,*,一段,基本形,試みる,ココロミル,ココロミル
者	名詞,非自立,一般,*,*,*,者,モノ,モノ
い	動詞,自立,*,*,一段,連用形,いる,イ,イ
庁	名詞,接尾,一般,*,*,*,庁,チョウ,チョー
思惑	名詞,一般,*,*,*,*,思惑,オモワク,オモワク
あっ	動詞,自立,*,*,五段・ラ行,連用タ接続,ある,アッ,アッ
分裂	名詞,サ変接続,*,*,*,*,分裂,ブンレツ,ブンレツ
状態	名詞,一般,*,*,*,*,状態,ジョウタイ,ジョータイ
続い	動詞,自立,*,*,五段・カ行イ音便,連用タ接続,続く,ツヅイ,ツズイ
侵攻	名詞,サ変接続,*,*,*,*,侵攻,シンコウ,シンコー
ナポレオン・ボナパルト	名詞,一般,*,*,*,*,*
全	接頭詞,名詞接続,*,*,*,*,全,ゼン,ゼン
手中	名詞,一般,*,*,*,*,手中,シュチュウ,シュチュー
納め	動詞,自立,*,*,一段,連用形,納める,オサメ,オサメ
失脚	名詞,サ変接続,*,*,*,*,失脚,シッキャク,シッキャク
ヴェネツィア	名詞,一般,*,*,*,*,*
ジェノヴァ	名詞,一般,*,*,*,*,*
元	名詞,一般,*,*,*,*,元,モト,モト
戻っ	動詞,自立,*,*,五段・ラ行,連用タ接続,戻る,モドッ,モドッ
ジュゼッペ・ガリバルディ	名詞,一般,*,*,*,*,*
月	名詞,接尾,助数詞,*,*,*,月,ツキ,ツキ
ら	名詞,接尾,一般,*,*,*,ら,ラ,ラ
戦果	名詞,一般,*,*,*,*,戦果,センカ,センカ
継承	名詞,サ変接続,*,*,*,*,継承,ケイショウ,ケイショー
ヴィットーリオ・エマヌエーレ	名詞,一般,*,*,*,*,*
樹立	名詞,サ変接続,*,*,*,*,樹立,ジュリツ,ジュリツ
名	名詞,接尾,一般,*,*,*,名,メイ,メイ
新生	名詞,固有名詞,組織,*,*,*,新生,シンセイ,シンセイ
戻ら	動詞,自立,*,*,五段・ラ行,未然形,戻る,モドラ,モドラ
ガリバルディ	名詞,一般,*,*,*,*,*
ナショナリズム	名詞,一般,*,*,*,*,ナショナリズム,ナショナリズム,ナショナリズム
掲げ	動詞,自立,*,*,一段,連用形,掲げる,カカゲ,カカゲ
かかわら	動詞,自立,*,*,五段・ラ行,未然形,かかわる,カカワラ,カカワラ
そのもの	名詞,一般,*,*,*,*,そのもの,ソノモノ,ソノモノ
という	助詞,格助詞,連語,*,*,*,という,トイウ,トユウ
から	助詞,接続助詞,*,*,*,*,から,カラ,カラ
不平等	名詞,一般,*,*,*,*,不平等,フビョウドウ,フビョードー
修好	名詞,サ変接続,*,*,*,*,修好,シュウコウ,シューコー
通商	名詞,サ変接続,*,*,*,*,通商,ツウショウ,ツーショー
締結	名詞,サ変接続,*,*,*,*,締結,テイケツ,テイケツ
国交	名詞,一般,*,*,*,*,国交,コッコウ,コッコー
岩倉	名詞,固有名詞,組織,*,*,*,岩倉,イワクラ,イワクラ
使節	名詞,一般,*,*,*,*,使節,シセツ,シセツ
団	名詞,接尾,一般,*,*,*,団,ダン,ダン
歴訪	名詞,サ変接続,*,*,*,*,歴訪,レキホウ,レキホー
当時	名詞,副詞可能,*,*,*,*,当時,トウジ,トージ
様子	名詞,一般,*,*,*,*,様子,ヨウス,ヨース
米	名詞,接尾,一般,*,*,*,米,マイ,マイ
欧	名詞,固有名詞,地域,一般,*,*,欧,オウ,オー
回覧	名詞,サ変接続,*,*,*,*,回覧,カイラン,カイラン
実記	名詞,一般,*,*,*,*,実記,ジッキ,ジッキ
イラスト	名詞,一般,*,*,*,*,イラスト,イラスト,イラスト
つき	名詞,接尾,一般,*,*,*,つき,ツキ,ツキ
詳しく	形容詞,自立,*,*,形容詞・イ段,連用テ接続,詳しい,クワシク,クワシク
記さ	動詞,自立,*,*,五段・サ行,未然形,記す,シルサ,シルサ
進軍	名詞,サ変接続,*,*,*,*,進軍,シングン,シングン
クーデター	名詞,一般,*,*,*,*,クーデター,クーデター,クーデター
ベニート・ムッソリーニ	名詞,一般,*,*,*,*,*
首相	名詞,一般,*,*,*,*,首相,シュショウ,シュショー
ムッソリーニ	名詞,一般,*,*,*,*,*
権力	名詞,一般,*,*,*,*,権力,ケンリョク,ケンリョク
集中	名詞,サ変接続,*,*,*,*,集中,シュウチュウ,シューチュー
進め	動詞,自立,*,*,一段,連用形,進める,ススメ,ススメ
ファシズム	名詞,一般,*,*,*,*,ファシズム,ファシズム,ファシズム
独裁	名詞,サ変接続,*,*,*,*,独裁,ドクサイ,ドクサイ
体制	名詞,一般,*,*,*,*,体制,タイセイ,タイセイ
確立	名詞,サ変接続,*,*,*,*,確立,カクリツ,カクリツ
せ	動詞,接尾,*,*,一段,連用形,せる,セ,セ
間	名詞,一般,*,*,*,*,間,マ,マ
ラテラノ	名詞,一般,*,*,*,*,*
結び	動詞,自立,*,*,五段・バ行,連用形,結ぶ,ムスビ,ムスビ
修復	名詞,サ変接続,*,*,*,*,修復,シュウフク,シューフク
国王	名詞,一般,*,*,*,*,国王,コクオウ,コクオー
指導	名詞,サ変接続,*,*,*,*,指導,シドウ,シドー
もと	名詞,一般,*,*,*,*,もと,モト,モト
回復	名詞,サ変接続,*,*,*,*,回復,カイフク,カイフク
成功	名詞,サ変接続,*,*,*,*,成功,セイコウ,セイコー
称賛	名詞,サ変接続,*,*,*,*,称賛,ショウサン,ショーサン
得	動詞,自立,*,*,一段,連用形,得る,エ,エ
ものの	助詞,接続助詞,*,*,*,*,ものの,モノノ,モノノ
エチオピア	名詞,固有名詞,地域,国,*,*,エチオピア,エチオピア,エチオピア
再度	副詞,助詞類接続,*,*,*,*,再度,サイド,サイド
化	名詞,接尾,サ変接続,*,*,*,化,カ,カ
す	動詞,自立,*,*,サ変・スル,文語基本形,する,ス,ス
べく	助動詞,*,*,*,文語・ベシ,連用形,べし,ベク,ベク
拡張	名詞,サ変接続,*,*,*,*,拡張,カクチョウ,カクチョー
政策	名詞,一般,*,*,*,*,政策,セイサク,セイサク
とる	動詞,自立,*,*,五段・ラ行,基本形,とる,トル,トル
とともに	助詞,格助詞,連語,*,*,*,とともに,トトモニ,トトモニ
独	名詞,固有名詞,地域,国,*,*,独,ドク,ドク
防共	名詞,一般,*,*,*,*,防共,ボウキョウ,ボーキョー
勃発	名詞,サ変接続,*,*,*,*,勃発,ボッパツ,ボッパツ
参戦	名詞,サ変接続,*,*,*,*,参戦,サンセン,サンセン
同年	名詞,副詞可能,*,*,*,*,同年,ドウネン,ドーネン
同盟	名詞,サ変接続,*,*,*,*,同盟,ドウメイ,ドーメイ
対	名詞,接続詞的,*,*,*,*,対,タイ,タイ
米	名詞,固有名詞,地域,国,*,*,米,ベイ,ベイ
宣戦	名詞,サ変接続,*,*,*,*,宣戦,センセン,センセン
布告	名詞,サ変接続,*,*,*,*,布告,フコク,フコク
行っ	動詞,自立,*,*,五段・ワ行促音便,連用タ接続,行う,オコナッ,オコナッ
敗色	名詞,一般,*,*,*,*,敗色,ハイショク,ハイショク
濃い	形容詞,自立,*,*,形容詞・アウオ段,基本形,濃い,コイ,コイ
側	名詞,接尾,一般,*,*,*,側,ガワ,ガワ
鞍替え	名詞,一般,*,*,*,*,鞍替え,クラガエ,クラガエ
救出	名詞,サ変接続,*,*,*,*,救出,キュウシュツ,キューシュツ
首班	名詞,一般,*,*,*,*,首班,シュハン,シュハン
傀儡	名詞,一般,*,*,*,*,傀儡,カイライ,カイライ
北イタリア	名詞,固有名詞,地域,一般,*,*,北イタリア,キタイタリア,キタイタリア
敗北	名詞,サ変接続,*,*,*,*,敗北,ハイボク,ハイボク
同	接頭詞,名詞接続,*,*,*,*,同,ドウ,ドー
崩壊	名詞,サ変接続,*,*,*,*,崩壊,ホウカイ,ホーカイ
王位	名詞,一般,*,*,*,*,王位,オウイ,オーイ
惜し	形容詞,自立,*,*,形容詞・イ段,ガル接続,惜しい,オシ,オシ
後押し	名詞,サ変接続,*,*,*,*,後押し,アトオシ,アトオシ
形	名詞,一般,*,*,*,*,形,カタチ,カタチ
サヴォイア	名詞,一般,*,*,*,*,*
王家	名詞,一般,*,*,*,*,王家,オウケ,オーケ
信頼	名詞,サ変接続,*,*,*,*,信頼,シンライ,シンライ
失い	動詞,自立,*,*,五段・ワ行促音便,連用形,失う,ウシナイ,ウシナイ
つつ	助詞,接続助詞,*,*,*,*,つつ,ツツ,ツツ
伝統	名詞,一般,*,*,*,*,伝統,デントウ,デントー
王室	名詞,一般,*,*,*,*,王室,オウシツ,オーシツ
強固	名詞,形容動詞語幹,*,*,*,*,強固,キョウコ,キョーコ
支持	名詞,サ変接続,*,*,*,*,支持,シジ,シジ
信任	名詞,サ変接続,*,*,*,*,信任,シンニン,シンニン
強い	形容詞,自立,*,*,形容詞・アウオ段,基本形,強い,ツヨイ,ツヨイ
基盤	名詞,一般,*,*,*,*,基盤,キバン,キバン
あっ	助動詞,*,*,*,五段・ラ行アル,連用タ接続,ある,アッ,アッ
カトリック	名詞,固有名詞,一般,*,*,*,カトリック,カトリック,カトリック
教会	名詞,一般,*,*,*,*,教会,キョウカイ,キョーカイ
中立	名詞,サ変接続,*,*,*,*,中立,チュウリツ,チューリツ
宣言	名詞,サ変接続,*,*,*,*,宣言,センゲン,センゲン
終結	名詞,サ変接続,*,*,*,*,終結,シュウケツ,シューケツ
後	名詞,接尾,副詞可能,*,*,*,後,ゴ,ゴ
行わ	動詞,自立,*,*,五段・ワ行促音便,未然形,行う,オコナワ,オコナワ
問う	動詞,自立,*,*,五段・ワ行促音便,基本形,問う,トウ,トウ
賛成	名詞,サ変接続,*,*,*,*,賛成,サンセイ,サンセイ
僅差	名詞,一般,*,*,*,*,僅差,キンサ,キンサ
決定	名詞,サ変接続,*,*,*,*,決定,ケッテイ,ケッテイ
ウン	名詞,固有名詞,一般,*,*,*,ウン,ウン,ウン
ベルト	名詞,一般,*,*,*,*,ベルト,ベルト,ベルト
廃位	名詞,一般,*,*,*,*,廃位,ハイイ,ハイイ
君主	名詞,一般,*,*,*,*,君主,クンシュ,クンシュ
初代	名詞,一般,*,*,*,*,初代,ショダイ,ショダイ
エンリコ・デ・ニコラ	名詞,一般,*,*,*,*,*
就任	名詞,サ変接続,*,*,*,*,就任,シュウニン,シューニン
冷戦	名詞,一般,*,*,*,*,冷戦,レイセン,レイセン
主義	名詞,一般,*,*,*,*,主義,シュギ,シュギ
受け	動詞,自立,*,*,一段,連用形,受ける,ウケ,ウケ
ながら	助詞,接続助詞,*,*,*,*,ながら,ナガラ,ナガラ
アメリカ合衆国	名詞,固有名詞,地域,国,*,*,アメリカ合衆国,アメリカガッシュウコク,アメリカガッシューコク
西ドイツ	名詞,固有名詞,地域,国,*,*,西ドイツ,ニシドイツ,ニシドイツ
西側	名詞,一般,*,*,*,*,西側,ニシガワ,ニシガワ
諸国	名詞,一般,*,*,*,*,諸国,ショコク,ショコク
東側	名詞,一般,*,*,*,*,東側,ヒガシガワ,ヒガシガワ
対峙	名詞,サ変接続,*,*,*,*,対峙,タイジ,タイジ
首脳	名詞,一般,*,*,*,*,首脳,シュノウ,シュノー
会議	名詞,サ変接続,*,*,*,*,会議,カイギ,カイギ
だけ	助詞,副助詞,*,*,*,*,だけ,ダケ,ダケ
なく	助動詞,*,*,*,特殊・ナイ,連用テ接続,ない,ナク,ナク
側面	名詞,一般,*,*,*,*,側面,ソクメン,ソクメン
において	助詞,格助詞,連語,*,*,*,において,ニオイテ,ニオイテ
重要	名詞,形容動詞語幹,*,*,*,*,重要,ジュウヨウ,ジューヨー
占める	動詞,自立,*,*,一段,基本形,占める,シメル,シメル
元首	名詞,一般,*,*,*,*,元首,ゲンシュ,ゲンシュ
選出	名詞,サ変接続,*,*,*,*,選出,センシュツ,センシュツ
間接	名詞,一般,*,*,*,*,間接,カンセツ,カンセツ
選挙	名詞,サ変接続,*,*,*,*,選挙,センキョ,センキョ
条件	名詞,一般,*,*,*,*,条件,ジョウケン,ジョーケン
歳	名詞,接尾,助数詞,*,*,*,歳,サイ,サイ
以上	名詞,非自立,副詞可能,*,*,*,以上,イジョウ,イジョー
任期	名詞,一般,*,*,*,*,任期,ニンキ,ニンキ
通常	名詞,一般,*,*,*,*,通常,ツウジョウ,ツージョー
内閣	名詞,一般,*,*,*,*,内閣,ナイカク,ナイカク
議会	名詞,一般,*,*,*,*,議会,ギカイ,ギカイ
基づく	動詞,自立,*,*,五段・カ行イ音便,基本形,基づく,モトヅク,モトズク
形式	名詞,一般,*,*,*,*,形式,ケイシキ,ケイシキ
権限	名詞,一般,*,*,*,*,権限,ケンゲン,ケンゲン
行使	名詞,サ変接続,*,*,*,*,行使,コウシ,コーシ
解散	名詞,サ変接続,*,*,*,*,解散,カイサン,カイサン
を通じて	助詞,格助詞,連語,*,*,*,を通じて,ヲツウジテ,ヲツージテ
実権	名詞,一般,*,*,*,*,実権,ジッケン,ジッケン
発動	名詞,サ変接続,*,*,*,*,発動,ハツドウ,ハツドー
可能	名詞,形容動詞語幹,*,*,*,*,可能,カノウ,カノー
秘め	動詞,自立,*,*,一段,連用形,秘める,ヒメ,ヒメ
統轄	名詞,サ変接続,*,*,*,*,統轄,トウカツ,トーカツ
指名	名詞,サ変接続,*,*,*,*,指名,シメイ,シメイ
承認	名詞,サ変接続,*,*,*,*,承認,ショウニン,ショーニン
各省	名詞,一般,*,*,*,*,各省,カクショウ,カクショー
大臣	名詞,一般,*,*,*,*,大臣,ダイジン,ダイジン
基づき	動詞,自立,*,*,五段・カ行イ音便,連用形,基づく,モトヅキ,モトズキ
議院	名詞,一般,*,*,*,*,議院,ギイン,ギイン
採用	名詞,サ変接続,*,*,*,*,採用,サイヨウ,サイヨー
得	動詞,自立,*,*,一段,未然形,得る,エ,エ
なけれ	助動詞,*,*,*,特殊・ナイ,仮定形,ない,ナケレ,ナケレ
なら	動詞,非自立,*,*,五段・ラ行,未然形,なる,ナラ,ナラ
おはよう	感動詞,*,*,*,*,*,おはよう,オハヨウ,オハヨー
今日	名詞,副詞可能,*,*,*,*,今日,キョウ,キョー
総理	名詞,一般,*,*,*,*,総理,ソウリ,ソーリ
誰	名詞,代名詞,一般,*,*,*,誰,ダレ,ダレ
ジョーク	名詞,一般,*,*,*,*,ジョーク,ジョーク,ジョーク
広め	動詞,自立,*,*,一段,未然形,広める,ヒロメ,ヒロメ
ほど	助詞,副助詞,*,*,*,*,ほど,ホド,ホド
頻繁	名詞,形容動詞語幹,*,*,*,*,頻繁,ヒンパン,ヒンパン
名高く	形容詞,自立,*,*,形容詞・アウオ段,連用テ接続,名高い,ナダカク,ナダカク
今	名詞,副詞可能,*,*,*,*,今,イマ,イマ
傾向	名詞,一般,*,*,*,*,傾向,ケイコウ,ケイコー
おさまっ	動詞,自立,*,*,五段・ラ行,連用タ接続,おさまる,オサマッ,オサマッ
い	動詞,非自立,*,*,一段,未然形,いる,イ,イ
延べ	名詞,一般,*,*,*,*,延べ,ノベ,ノベ
抜か	動詞,自立,*,*,五段・カ行イ音便,未然形,抜く,ヌカ,ヌカ
ちなみに	接続詞,*,*,*,*,*,ちなみに,チナミニ,チナミニ
同じく	副詞,一般,*,*,*,*,同じく,オナジク,オナジク
期間	名詞,一般,*,*,*,*,期間,キカン,キカン
在任	名詞,サ変接続,*,*,*,*,在任,ザイニン,ザイニン
イギリス	名詞,固有名詞,地域,国,*,*,イギリス,イギリス,イギリス
カナダ	名詞,固有名詞,地域,国,*,*,カナダ,カナダ,カナダ
各	接頭詞,名詞接続,*,*,*,*,各,カク,カク
上院	名詞,固有名詞,組織,*,*,*,上院,ジョウイン,ジョーイン
下院	名詞,固有名詞,組織,*,*,*,下院,カイン,カイン
構成	名詞,サ変接続,*,*,*,*,構成,コウセイ,コーセイ
両院	名詞,一般,*,*,*,*,両院,リョウイン,リョーイン
二院	名詞,一般,*,*,*,*,二院,ニイン,ニイン
民選	名詞,一般,*,*,*,*,民選,ミンセン,ミンセン
議員	名詞,一般,*,*,*,*,議員,ギイン,ギイン
議席	名詞,一般,*,*,*,*,議席,ギセキ,ギセキ
終身	名詞,一般,*,*,*,*,終身,シュウシン,シューシン
名	名詞,接尾,助数詞,*,*,*,名,メイ,メイ
経験	名詞,サ変接続,*,*,*,*,経験,ケイケン,ケイケン
本人	名詞,一般,*,*,*,*,本人,ホンニン,ホンニン
拒絶	名詞,サ変接続,*,*,*,*,拒絶,キョゼツ,キョゼツ
限り	名詞,非自立,副詞可能,*,*,*,限り,カギリ,カギリ
たる	助動詞,*,*,*,文語・ナリ,体言接続,たり,タル,タル
資格	名詞,一般,*,*,*,*,資格,シカク,シカク
科学	名詞,一般,*,*,*,*,科学,カガク,カガク
分野	名詞,一般,*,*,*,*,分野,ブンヤ,ブンヤ
名誉	名詞,形容動詞語幹,*,*,*,*,名誉,メイヨ,メイヨ
高め	動詞,自立,*,*,一段,連用形,高める,タカメ,タカメ
功労	名詞,一般,*,*,*,*,功労,コウロウ,コーロー
一方	接続詞,*,*,*,*,*,一方,イッポウ,イッポー
衆議院	名詞,固有名詞,組織,*,*,*,衆議院,シュウギイン,シューギイン
優越	名詞,サ変接続,*,*,*,*,優越,ユウエツ,ユーエツ
認め	動詞,自立,*,*,一段,未然形,認める,ミトメ,ミトメ
権能	名詞,一般,*,*,*,*,権能,ケンノウ,ケンノー
完全	名詞,形容動詞語幹,*,*,*,*,完全,カンゼン,カンゼン
対等	名詞,一般,*,*,*,*,対等,タイトウ,タイトー
双方	名詞,一般,*,*,*,*,双方,ソウホウ,ソーホー
うる	動詞,非自立,*,*,一段・得ル,基本形,うる,ウル,ウル
開票	名詞,サ変接続,*,*,*,*,開票,カイヒョウ,カイヒョー
超す	動詞,自立,*,*,五段・サ行,基本形,超す,コス,コス
反対	名詞,サ変接続,*,*,*,*,反対,ハンタイ,ハンタイ
退陣	名詞,サ変接続,*,*,*,*,退陣,タイジン,タイジン
シルヴィオ・ベルルスコーニ	名詞,一般,*,*,*,*,*
ベルルスコーニ	名詞,固有名詞,人名,姓,*,*,ベルルスコーニ,ベルルスコーニ,ベルルスコーニ
右派	名詞,一般,*,*,*,*,右派,ウハ,ウハ
連立	名詞,サ変接続,*,*,*,*,連立,レンリツ,レンリツ
野党	名詞,一般,*,*,*,*,野党,ヤトウ,ヤトー
中道	名詞,一般,*,*,*,*,中道,チュウドウ,チュードー
左派	名詞,一般,*,*,*,*,左派,サハ,サハ
押し切っ	動詞,自立,*,*,五段・ラ行,連用タ接続,押し切る,オシキッ,オシキッ
通過	名詞,サ変接続,*,*,*,*,通過,ツウカ,ツーカ
中身	名詞,一般,*,*,*,*,中身,ナカミ,ナカミ
移し	動詞,自立,*,*,五段・サ行,連用形,移す,ウツシ,ウツシ
州	名詞,一般,*,*,*,*,州,シュウ,シュー
委譲	名詞,サ変接続,*,*,*,*,委譲,イジョウ,イジョー
そのうち	副詞,一般,*,*,*,*,そのうち,ソノウチ,ソノウチ
南部	名詞,一般,*,*,*,*,南部,ナンブ,ナンブ
占め	動詞,自立,*,*,一段,連用形,占める,シメ,シメ
提出	名詞,サ変接続,*,*,*,*,提出,テイシュツ,テイシュツ
棄権	名詞,サ変接続,*,*,*,*,棄権,キケン,キケン
月内	名詞,一般,*,*,*,*,月内,ゲツナイ,ゲツナイ
目指す	動詞,自立,*,*,五段・サ行,基本形,目指す,メザス,メザス
民主党	名詞,固有名詞,組織,*,*,*,民主党,ミンシュトウ,ミンシュトー
両日	名詞,一般,*,*,*,*,両日,リョウジツ,リョージツ
全国	名詞,一般,*,*,*,*,全国,ゼンコク,ゼンコク
抗議	名詞,サ変接続,*,*,*,*,抗議,コウギ,コーギ
行動	名詞,サ変接続,*,*,*,*,行動,コウドウ,コードー
計画	名詞,サ変接続,*,*,*,*,計画,ケイカク,ケイカク
本	接頭詞,名詞接続,*,*,*,*,本,ホン,ホン
提案	名詞,サ変接続,*,*,*,*,提案,テイアン,テイアン
公務員	名詞,一般,*,*,*,*,公務員,コウムイン,コームイン
給与	名詞,サ変接続,*,*,*,*,給与,キュウヨ,キューヨ
増	名詞,接尾,一般,*,*,*,増,ゾウ,ゾー
凍結	名詞,サ変接続,*,*,*,*,凍結,トウケツ,トーケツ
省庁	名詞,一般,*,*,*,*,省庁,ショウチョウ,ショーチョー
予算	名詞,一般,*,*,*,*,予算,ヨサン,ヨサン
削減	名詞,サ変接続,*,*,*,*,削減,サクゲン,サクゲン
地方自治体	名詞,一般,*,*,*,*,地方自治体,チホウジチタイ,チホージチタイ
交付	名詞,サ変接続,*,*,*,*,交付,コウフ,コーフ
金	名詞,接尾,一般,*,*,*,金,キン,キン
実行	名詞,サ変接続,*,*,*,*,実行,ジッコウ,ジッコー
今後	名詞,副詞可能,*,*,*,*,今後,コンゴ,コンゴ
年間	名詞,接尾,助数詞,*,*,*,年間,ネンカン,ネンカン
赤字	名詞,一般,*,*,*,*,赤字,アカジ,アカジ
比率	名詞,一般,*,*,*,*,比率,ヒリツ,ヒリツ
比	名詞,接尾,一般,*,*,*,比,ヒ,ヒ
以内	名詞,非自立,副詞可能,*,*,*,以内,イナイ,イナイ
下げる	動詞,自立,*,*,一段,基本形,下げる,サゲル,サゲル
発表	名詞,サ変接続,*,*,*,*,発表,ハッピョウ,ハッピョー
スタブ	名詞,一般,*,*,*,*,スタブ,スタブ,スタブ
加筆	名詞,サ変接続,*,*,*,*,加筆,カヒツ,カヒツ
法律	名詞,一般,*,*,*,*,法律,ホウリツ,ホーリツ
刑事	名詞,一般,*,*,*,*,刑事,ケイジ,ケイジ
市民	名詞,一般,*,*,*,*,市民,シミン,シミン
裁判官	名詞,一般,*,*,*,*,裁判官,サイバンカン,サイバンカン
一緒	名詞,サ変接続,*,*,*,*,一緒,イッショ,イッショ
審理	名詞,サ変接続,*,*,*,*,審理,シンリ,シンリ
参	名詞,サ変接続,*,*,*,*,参,サン,サン
審	名詞,接尾,一般,*,*,*,審,シン,シン
裁判	名詞,一般,*,*,*,*,裁判,サイバン,サイバン
殺人	名詞,一般,*,*,*,*,殺人,サツジン,サツジン
重大	名詞,形容動詞語幹,*,*,*,*,重大,ジュウダイ,ジューダイ
事件	名詞,一般,*,*,*,*,事件,ジケン,ジケン
対象	名詞,一般,*,*,*,*,対象,タイショウ,タイショー
重罪	名詞,一般,*,*,*,*,重罪,ジュウザイ,ジューザイ
控訴	名詞,サ変接続,*,*,*,*,控訴,コウソ,コーソ
よる	動詞,自立,*,*,五段・ラ行,基本形,よる,ヨル,ヨル
上告	名詞,サ変接続,*,*,*,*,上告,ジョウコク,ジョーコク
最高裁	名詞,固有名詞,組織,*,*,*,最高裁,サイコウサイ,サイコーサイ
にあたる	助詞,格助詞,連語,*,*,*,にあたる,ニアタル,ニアタル
破棄	名詞,サ変接続,*,*,*,*,破棄,ハキ,ハキ
担当	名詞,サ変接続,*,*,*,*,担当,タントウ,タントー
判断	名詞,サ変接続,*,*,*,*,判断,ハンダン,ハンダン
必要	名詞,形容動詞語幹,*,*,*,*,必要,ヒツヨウ,ヒツヨー
ケース	名詞,一般,*,*,*,*,ケース,ケース,ケース
裁判所	名詞,一般,*,*,*,*,裁判所,サイバンショ,サイバンショ
移送	名詞,サ変接続,*,*,*,*,移送,イソウ,イソー
員	名詞,接尾,一般,*,*,*,員,イン,イン
以下	名詞,非自立,副詞可能,*,*,*,以下,イカ,イカ
中卒	名詞,一般,*,*,*,*,中卒,チュウソツ,チューソツ
高卒	名詞,一般,*,*,*,*,高卒,コウソツ,コーソツ
くじ引き	名詞,サ変接続,*,*,*,*,くじ引き,クジビキ,クジビキ
選ん	動詞,自立,*,*,五段・バ行,連用タ接続,選ぶ,エラン,エラン
だ	助動詞,*,*,*,特殊・タ,基本形,だ,ダ,ダ
希望	名詞,サ変接続,*,*,*,*,希望,キボウ,キボー
加え	動詞,自立,*,*,一段,連用形,加える,クワエ,クワエ
名簿	名詞,一般,*,*,*,*,名簿,メイボ,メイボ
か月	名詞,接尾,助数詞,*,*,*,か月,カゲツ,カゲツ
ごと	名詞,接尾,一般,*,*,*,ごと,ゴト,ゴト
再び	副詞,助詞類接続,*,*,*,*,再び,フタタビ,フタタビ
起訴	名詞,サ変接続,*,*,*,*,起訴,キソ,キソ
部隊	名詞,一般,*,*,*,*,部隊,ブタイ,ブタイ
アフガニスタン	名詞,固有名詞,地域,国,*,*,アフガニスタン,アフガニスタン,アフガニスタン
従軍	名詞,サ変接続,*,*,*,*,従軍,ジュウグン,ジューグン
アルピーニ	名詞,一般,*,*,*,*,*
兵	名詞,接尾,一般,*,*,*,兵,ヘイ,ヘイ
西部	名詞,一般,*,*,*,*,西部,セイブ,セイブ
地区	名詞,一般,*,*,*,*,地区,チク,チク
軍	名詞,一般,*,*,*,*,軍,グン,グン
指揮	名詞,サ変接続,*,*,*,*,指揮,シキ,シキ
委ね	動詞,自立,*,*,一段,未然形,委ねる,ユダネ,ユダネ
軽	接頭詞,名詞接続,*,*,*,*,軽,ケイ,ケイ
空母	名詞,一般,*,*,*,*,空母,クウボ,クーボ
カヴール	名詞,一般,*,*,*,*,*
フレッチェ・トリコローリ	名詞,一般,*,*,*,*,*
軍	名詞,接尾,一般,*,*,*,軍,グン,グン
徴兵	名詞,サ変接続,*,*,*,*,徴兵,チョウヘイ,チョーヘイ
より	助詞,格助詞,一般,*,*,*,より,ヨリ,ヨリ
志願	名詞,サ変接続,*,*,*,*,志願,シガン,シガン
制度	名詞,一般,*,*,*,*,制度,セイド,セイド
期限	名詞,一般,*,*,*,*,期限,キゲン,キゲン
種	名詞,接尾,助数詞,*,*,*,種,シュ,シュ
最年少	名詞,一般,*,*,*,*,最年少,サイネンショウ,サイネンショー
兵士	名詞,一般,*,*,*,*,兵士,ヘイシ,ヘイシ
費	名詞,接尾,一般,*,*,*,費,ヒ,ヒ
ドル	名詞,接尾,助数詞,*,*,*,ドル,ドル,ドル
フィアット	名詞,一般,*,*,*,*,*
アレーニア・アエルマッキ	名詞,一般,*,*,*,*,*
アエルマッキ	名詞,一般,*,*,*,*,*
企業	名詞,一般,*,*,*,*,企業,キギョウ,キギョー
国産	名詞,一般,*,*,*,*,国産,コクサン,コクサン
戦闘	名詞,サ変接続,*,*,*,*,戦闘,セントウ,セントー
機	名詞,接尾,一般,*,*,*,機,キ,キ
車両	名詞,一般,*,*,*,*,車両,シャリョウ,シャリョー
中近東	名詞,固有名詞,地域,一般,*,*,中近東,チュウキントウ,チューキントー
アジア	名詞,固有名詞,地域,一般,*,*,アジア,アジア,アジア
輸出	名詞,サ変接続,*,*,*,*,輸出,ユシュツ,ユシュツ
独自	名詞,形容動詞語幹,*,*,*,*,独自,ドクジ,ドクジ
核兵器	名詞,一般,*,*,*,*,核兵器,カクヘイキ,カクヘイキ
核	名詞,一般,*,*,*,*,核,カク,カク
戦力	名詞,一般,*,*,*,*,戦力,センリョク,センリョク
保持	名詞,サ変接続,*,*,*,*,保持,ホジ,ホジ
ニュー	名詞,一般,*,*,*,*,ニュー,ニュー,ニュー
クリア	名詞,サ変接続,*,*,*,*,クリア,クリア,クリア
シェアリング	名詞,一般,*,*,*,*,シェアリング,シェアリング,シェアリング
抑止	名詞,サ変接続,*,*,*,*,抑止,ヨクシ,ヨクシ
現役	名詞,一般,*,*,*,*,現役,ゲンエキ,ゲンエキ
約	接頭詞,数接続,*,*,*,*,約,ヤク,ヤク
予備	名詞,一般,*,*,*,*,予備,ヨビ,ヨビ
役	名詞,接尾,一般,*,*,*,役,ヤク,ヤク
所属	名詞,サ変接続,*,*,*,*,所属,ショゾク,ショゾク
ソ連	名詞,固有名詞,地域,国,*,*,ソ連,ソレン,ソレン
黒海	名詞,固有名詞,地域,一般,*,*,黒海,コッカイ,コッカイ
艦隊	名詞,一般,*,*,*,*,艦隊,カンタイ,カンタイ
仮想	名詞,サ変接続,*,*,*,*,仮想,カソウ,カソー
敵対	名詞,サ変接続,*,*,*,*,敵対,テキタイ,テキタイ
目標	名詞,一般,*,*,*,*,目標,モクヒョウ,モクヒョー
行為	名詞,サ変接続,*,*,*,*,行為,コウイ,コーイ
擁し	動詞,自立,*,*,五段・サ行,連用形,擁す,ヨウシ,ヨーシ
でも	助詞,副助詞,*,*,*,*,でも,デモ,デモ
重視	名詞,サ変接続,*,*,*,*,重視,ジュウシ,ジューシ
変わら	動詞,自立,*,*,五段・ラ行,未然形,変わる,カワラ,カワラ
法	名詞,一般,*,*,*,*,法,ホウ,ホー
改正	名詞,サ変接続,*,*,*,*,改正,カイセイ,カイセイ
保有	名詞,サ変接続,*,*,*,*,保有,ホユウ,ホユー
次いで	接続詞,*,*,*,*,*,次いで,ツイデ,ツイデ
戦列	名詞,一般,*,*,*,*,戦列,センレツ,センレツ
加わる	動詞,自立,*,*,五段・ラ行,基本形,加わる,クワワル,クワワル
新型	名詞,一般,*,*,*,*,新型,シンガタ,シンガタ
戦車	名詞,一般,*,*,*,*,戦車,センシャ,センシャ
配備	名詞,サ変接続,*,*,*,*,配備,ハイビ,ハイビ
滞り	動詞,自立,*,*,五段・ラ行,連用形,滞る,トドコオリ,トドコーリ
がち	名詞,接尾,形容動詞語幹,*,*,*,がち,ガチ,ガチ
比べ	動詞,自立,*,*,一段,連用形,比べる,クラベ,クラベ
一層	副詞,助詞類接続,*,*,*,*,一層,イッソウ,イッソー
強化	名詞,サ変接続,*,*,*,*,強化,キョウカ,キョーカ
進め	動詞,自立,*,*,一段,未然形,進める,ススメ,ススメ
自衛隊	名詞,固有名詞,組織,*,*,*,自衛隊,ジエイタイ,ジエイタイ
装備	名詞,サ変接続,*,*,*,*,装備,ソウビ,ソービ
共通	名詞,サ変接続,*,*,*,*,共通,キョウツウ,キョーツー
点	名詞,接尾,一般,*,*,*,点,テン,テン
多く	形容詞,自立,*,*,形容詞・アウオ段,連用テ接続,多い,オオク,オーク
役割	名詞,一般,*,*,*,*,役割,ヤクワリ,ヤクワリ
類似	名詞,サ変接続,*,*,*,*,類似,ルイジ,ルイジ
入れ替わる	動詞,自立,*,*,五段・ラ行,基本形,入れ替わる,イレカワル,イレカワル
旧式	名詞,形容動詞語幹,*,*,*,*,旧式,キュウシキ,キューシキ
改修	名詞,サ変接続,*,*,*,*,改修,カイシュウ,カイシュー
ヘリコプター	名詞,一般,*,*,*,*,ヘリコプター,ヘリコプター,ヘリコプター
揚陸	名詞,一般,*,*,*,*,揚陸,ヨウリク,ヨーリク
艦	名詞,接尾,一般,*,*,*,艦,カン,カン
運用	名詞,サ変接続,*,*,*,*,運用,ウンヨウ,ウンヨー
後継	名詞,一般,*,*,*,*,後継,コウケイ,コーケイ
トン	名詞,接尾,助数詞,*,*,*,トン,トン,トン
強襲	名詞,サ変接続,*,*,*,*,強襲,キョウシュウ,キョーシュー
トリエステ	名詞,固有名詞,地域,一般,*,*,トリエステ,トリエステ,トリエステ
艤装	名詞,サ変接続,*,*,*,*,艤装,ギソウ,ギソー
要員	名詞,一般,*,*,*,*,要員,ヨウイン,ヨーイン
なり	動詞,自立,*,*,五段・ラ行,連用形,なる,ナリ,ナリ
ファイター	名詞,一般,*,*,*,*,ファイター,ファイター,ファイター
タイフーン	名詞,一般,*,*,*,*,*
線	名詞,接尾,助数詞,*,*,*,線,セン,セン
航空機	名詞,一般,*,*,*,*,航空機,コウクウキ,コークーキ
熱心	名詞,形容動詞語幹,*,*,*,*,熱心,ネッシン,ネッシン
アエリタリア	名詞,一般,*,*,*,*,*
旧	接頭詞,名詞接続,*,*,*,*,旧,キュウ,キュー
社	名詞,接尾,一般,*,*,*,社,シャ,シャ
部門	名詞,一般,*,*,*,*,部門,ブモン,ブモン
復興	名詞,サ変接続,*,*,*,*,復興,フッコウ,フッコー
ま	フィラー,*,*,*,*,*,ま,マ,マ
ない	形容詞,自立,*,*,形容詞・アウオ段,基本形,ない,ナイ,ナイ
時期	名詞,副詞可能,*,*,*,*,時期,ジキ,ジキ
性能	名詞,一般,*,*,*,*,性能,セイノウ,セイノー
誇り	動詞,自立,*,*,五段・ラ行,連用形,誇る,ホコリ,ホコリ
こだわる	動詞,自立,*,*,五段・ラ行,基本形,こだわる,コダワル,コダワル
拒ん	動詞,自立,*,*,五段・マ行,連用タ接続,拒む,コバン,コバン
ジーナ	名詞,固有名詞,一般,*,*,*,*
愛称	名詞,一般,*,*,*,*,愛称,アイショウ,アイショー
長らく	副詞,一般,*,*,*,*,長らく,ナガラク,ナガラク
愛用	名詞,サ変接続,*,*,*,*,愛用,アイヨウ,アイヨー
のみ	助詞,副助詞,*,*,*,*,のみ,ノミ,ノミ
機種	名詞,一般,*,*,*,*,機種,キシュ,キシュ
組織	名詞,サ変接続,*,*,*,*,組織,ソシキ,ソシキ
間	名詞,接尾,一般,*,*,*,間,カン,カン
交流	名詞,サ変接続,*,*,*,*,交流,コウリュウ,コーリュー
盛ん	名詞,形容動詞語幹,*,*,*,*,盛ん,サカン,サカン
近年	名詞,副詞可能,*,*,*,*,近年,キンネン,キンネン
見	動詞,自立,*,*,一段,未然形,見る,ミ,ミ
欧米	名詞,固有名詞,地域,一般,*,*,欧米,オウベイ,オーベイ
共同	名詞,サ変接続,*,*,*,*,共同,キョウドウ,キョードー
意欲	名詞,一般,*,*,*,*,意欲,イヨク,イヨク
見せ	動詞,自立,*,*,一段,連用形,見せる,ミセ,ミセ
増産	名詞,サ変接続,*,*,*,*,増産,ゾウサン,ゾーサン
意向	名詞,一般,*,*,*,*,意向,イコウ,イコー
示し	動詞,自立,*,*,五段・サ行,連用形,示す,シメシ,シメシ
憲兵	名詞,一般,*,*,*,*,憲兵,ケンペイ,ケンペイ
そのまま	副詞,一般,*,*,*,*,そのまま,ソノママ,ソノママ
称する	動詞,自立,*,*,サ変・－スル,基本形,称する,ショウスル,ショースル
隊	名詞,接尾,一般,*,*,*,隊,タイ,タイ
国防省	名詞,固有名詞,組織,*,*,*,国防省,コクボウショウ,コクボーショー
さまざま	名詞,形容動詞語幹,*,*,*,*,さまざま,サマザマ,サマザマ
訳さ	動詞,自立,*,*,五段・サ行,未然形,訳す,ヤクサ,ヤクサ
平時	名詞,一般,*,*,*,*,平時,ヘイジ,ヘイジ
各種	名詞,一般,*,*,*,*,各種,カクシュ,カクシュ
活動	名詞,サ変接続,*,*,*,*,活動,カツドウ,カツドー
警備	名詞,サ変接続,*,*,*,*,警備,ケイビ,ケイビ
事故	名詞,一般,*,*,*,*,事故,ジコ,ジコ
対応	名詞,サ変接続,*,*,*,*,対応,タイオウ,タイオー
反	接頭詞,名詞接続,*,*,*,*,反,ハン,ハン
グループ	名詞,一般,*,*,*,*,グループ,グループ,グループ
犯罪	名詞,一般,*,*,*,*,犯罪,ハンザイ,ハンザイ
摘発	名詞,サ変接続,*,*,*,*,摘発,テキハツ,テキハツ
戦時	名詞,一般,*,*,*,*,戦時,センジ,センジ
戦地	名詞,一般,*,*,*,*,戦地,センチ,センチ
行う	動詞,自立,*,*,五段・ワ行促音便,基本形,行う,オコナウ,オコナウ
テロリズム	名詞,一般,*,*,*,*,テロリズム,テロリズム,テロリズム
テロ	名詞,一般,*,*,*,*,テロ,テロ,テロ
対策	名詞,サ変接続,*,*,*,*,対策,タイサク,タイサク
要人	名詞,一般,*,*,*,*,要人,ヨウジン,ヨージン
警護	名詞,サ変接続,*,*,*,*,警護,ケイゴ,ケイゴ
人質	名詞,一般,*,*,*,*,人質,ヒトジチ,ヒトジチ
作戦	名詞,一般,*,*,*,*,作戦,サクセン,サクセン
特殊	名詞,形容動詞語幹,*,*,*,*,特殊,トクシュ,トクシュ
介入	名詞,サ変接続,*,*,*,*,介入,カイニュウ,カイニュー
イラク	名詞,固有名詞,地域,国,*,*,イラク,イラク,イラク
戦歴	名詞,一般,*,*,*,*,戦歴,センレキ,センレキ
重ね	動詞,自立,*,*,一段,連用形,重ねる,カサネ,カサネ
諜報	名詞,一般,*,*,*,*,諜報,チョウホウ,チョーホー
同国	名詞,一般,*,*,*,*,同国,ドウコク,ドーコク
とき	名詞,非自立,副詞可能,*,*,*,とき,トキ,トキ
軍部	名詞,一般,*,*,*,*,軍部,グンブ,グンブ
試行錯誤	名詞,一般,*,*,*,*,試行錯誤,シコウサクゴ,シコーサクゴ
成長	名詞,サ変接続,*,*,*,*,成長,セイチョウ,セイチョー
民間	名詞,一般,*,*,*,*,民間,ミンカン,ミンカン
連携	名詞,サ変接続,*,*,*,*,連携,レンケイ,レンケイ
わけ	名詞,非自立,一般,*,*,*,わけ,ワケ,ワケ
いか	動詞,自立,*,*,五段・カ行促音便,未然形,いく,イカ,イカ
なかっ	助動詞,*,*,*,特殊・ナイ,連用タ接続,ない,ナカッ,ナカッ
相手	名詞,一般,*,*,*,*,相手,アイテ,アイテ
大手	名詞,一般,*,*,*,*,大手,オオテ,オーテ
グリエルモ・マルコーニ	名詞,一般,*,*,*,*,*
短波	名詞,一般,*,*,*,*,短波,タンパ,タンパ
無線	名詞,一般,*,*,*,*,無線,ムセン,ムセン
発明	名詞,サ変接続,*,*,*,*,発明,ハツメイ,ハツメイ
初頭	名詞,副詞可能,*,*,*,*,初頭,ショトウ,ショトー
実用	名詞,サ変接続,*,*,*,*,実用,ジツヨウ,ジツヨー
いっ	動詞,非自立,*,*,五段・カ行促音便,連用タ接続,いく,イッ,イッ
暗号	名詞,一般,*,*,*,*,暗号,アンゴウ,アンゴー
解読	名詞,サ変接続,*,*,*,*,解読,カイドク,カイドク
大切	名詞,形容動詞語幹,*,*,*,*,大切,タイセツ,タイセツ
移住	名詞,サ変接続,*,*,*,*,移住,イジュウ,イジュー
国内外	名詞,一般,*,*,*,*,国内外,コクナイガイ,コクナイガイ
分け	動詞,自立,*,*,一段,連用形,分ける,ワケ,ワケ
動く	動詞,自立,*,*,五段・カ行イ音便,基本形,動く,ウゴク,ウゴク
インテリジェンス	名詞,一般,*,*,*,*,インテリジェンス,インテリジェンス,インテリジェンス
こうした	連体詞,*,*,*,*,*,こうした,コウシタ,コーシタ
違う	動詞,自立,*,*,五段・ワ行促音便,基本形,違う,チガウ,チガウ
十分	名詞,形容動詞語幹,*,*,*,*,十分,ジュウブン,ジューブン
制御	名詞,サ変接続,*,*,*,*,制御,セイギョ,セイギョ
こ	動詞,非自立,*,*,カ変・クル,未然形,くる,コ,コ
置か	動詞,自立,*,*,五段・カ行イ音便,未然形,置く,オカ,オカ
国防	名詞,一般,*,*,*,*,国防,コクボウ,コクボー
同様	名詞,形容動詞語幹,*,*,*,*,同様,ドウヨウ,ドーヨー
そして	接続詞,*,*,*,*,*,そして,ソシテ,ソシテ
元	接頭詞,名詞接続,*,*,*,*,元,モト,モト
大佐	名詞,一般,*,*,*,*,大佐,タイサ,タイサ
逮捕	名詞,サ変接続,*,*,*,*,逮捕,タイホ,タイホ
しまっ	動詞,非自立,*,*,五段・ワ行促音便,連用タ接続,しまう,シマッ,シマッ
看過	名詞,サ変接続,*,*,*,*,看過,カンカ,カンカ
できる	動詞,自立,*,*,一段,基本形,できる,デキル,デキル
もれ	動詞,自立,*,*,一段,連用形,もれる,モレ,モレ
政財界	名詞,一般,*,*,*,*,政財界,セイザイカイ,セイザイカイ
世論	名詞,一般,*,*,*,*,世論,セロン,セロン
油	名詞,一般,*,*,*,*,油,アブラ,アブラ
注ぎ	動詞,自立,*,*,五段・ガ行,連用形,注ぐ,ソソギ,ソソギ
若干	名詞,副詞可能,*,*,*,*,若干,ジャッカン,ジャッカン
余儀なく	形容詞,自立,*,*,形容詞・アウオ段,連用テ接続,余儀ない,ヨギナク,ヨギナク
下	名詞,一般,*,*,*,*,下,シタ,シタ
分業	名詞,サ変接続,*,*,*,*,分業,ブンギョウ,ブンギョー
保安庁	名詞,固有名詞,組織,*,*,*,保安庁,ホアンチョウ,ホアンチョー
民主	名詞,一般,*,*,*,*,民主,ミンシュ,ミンシュ
前者	名詞,一般,*,*,*,*,前者,ゼンシャ,ゼンシャ
まきこま	動詞,自立,*,*,五段・マ行,未然形,まきこむ,マキコマ,マキコマ
長官	名詞,一般,*,*,*,*,長官,チョウカン,チョーカン
辞職	名詞,サ変接続,*,*,*,*,辞職,ジショク,ジショク
テレコムスキャンダル	名詞,一般,*,*,*,*,*
起き	動詞,自立,*,*,一段,連用形,起きる,オキ,オキ
体	名詞,接尾,一般,*,*,*,体,タイ,タイ
調整	名詞,サ変接続,*,*,*,*,調整,チョウセイ,チョーセイ
安全	名詞,形容動詞語幹,*,*,*,*,安全,アンゼン,アンゼン
保障	名詞,サ変接続,*,*,*,*,保障,ホショウ,ホショー
委員	名詞,一般,*,*,*,*,委員,イイン,イイン
設置	名詞,サ変接続,*,*,*,*,設置,セッチ,セッチ
盗聴	名詞,サ変接続,*,*,*,*,盗聴,トウチョウ,トーチョー
何	名詞,数,*,*,*,*,何,ナン,ナン
調べ	動詞,自立,*,*,一段,未然形,調べる,シラベ,シラベ
逸脱	名詞,サ変接続,*,*,*,*,逸脱,イツダツ,イツダツ
地形	名詞,一般,*,*,*,*,地形,チケイ,チケイ
最高峰	名詞,一般,*,*,*,*,最高峰,サイコウホウ,サイコーホー
モンテ・ビアンコ	名詞,一般,*,*,*,*,*
仏	名詞,固有名詞,地域,国,*,*,仏,フツ,フツ
モンブラン	名詞,固有名詞,地域,一般,*,*,モンブラン,モンブラン,モンブラン
突き出し	動詞,自立,*,*,五段・サ行,連用形,突き出す,ツキダシ,ツキダシ
長靴	名詞,一般,*,*,*,*,長靴,ナガグツ,ナガグツ
型	名詞,接尾,一般,*,*,*,型,ガタ,ガタ
島	名詞,一般,*,*,*,*,島,シマ,シマ
サルデーニャ	名詞,固有名詞,地域,一般,*,*,*
コルシカ	名詞,固有名詞,地域,一般,*,*,コルシカ,コルシカ,コルシカ
面し	動詞,自立,*,*,五段・サ行,連用形,面す,メンシ,メンシ
接する	動詞,自立,*,*,サ変・－スル,基本形,接する,セッスル,セッスル
大陸	名詞,一般,*,*,*,*,大陸,タイリク,タイリク
北側	名詞,一般,*,*,*,*,北側,キタガワ,キタガワ
スロヴェニア	名詞,一般,*,*,*,*,*
挟ん	動詞,自立,*,*,五段・マ行,連用タ接続,挟む,ハサン,ハサン
で	助詞,接続助詞,*,*,*,*,で,デ,デ
キリスト教	名詞,一般,*,*,*,*,キリスト教,キリストキョウ,キリストキョー
治める	動詞,自立,*,*,一段,基本形,治める,オサメル,オサメル
周囲	名詞,一般,*,*,*,*,周囲,シュウイ,シューイ
囲ん	動詞,自立,*,*,五段・マ行,連用タ接続,囲む,カコン,カコン
近く	名詞,副詞可能,*,*,*,*,近く,チカク,チカク
包み込む	動詞,自立,*,*,五段・マ行,基本形,包み込む,ツツミコム,ツツミコム
領内	名詞,一般,*,*,*,*,領内,リョウナイ,リョーナイ
飛び地	名詞,一般,*,*,*,*,飛び地,トビチ,トビチ
カンピョーネ・ディターリア	名詞,一般,*,*,*,*,*
弧	名詞,一般,*,*,*,*,弧,コ,コ
描き	動詞,自立,*,*,五段・カ行イ音便,連用形,描く,エガキ,エガキ
なし	動詞,自立,*,*,五段・サ行,連用形,なす,ナシ,ナシ
マッターホルン	名詞,固有名詞,地域,一般,*,*,マッターホルン,マッターホルン,マッターホルン
モンテ・ローザ	名詞,一般,*,*,*,*,*
モンテローザ	名詞,固有名詞,組織,*,*,*,モンテローザ,モンテローザ,モンテローザ
高峰	名詞,固有名詞,人名,姓,*,*,高峰,タカミネ,タカミネ
最高	名詞,一般,*,*,*,*,最高,サイコウ,サイコー
頂上	名詞,一般,*,*,*,*,頂上,チョウジョウ,チョージョー
付近	名詞,一般,*,*,*,*,付近,フキン,フキン
アルプス	名詞,固有名詞,地域,一般,*,*,アルプス,アルプス,アルプス
北西	名詞,一般,*,*,*,*,北西,ホクセイ,ホクセイ
分岐	名詞,サ変接続,*,*,*,*,分岐,ブンキ,ブンキ
縦断	名詞,サ変接続,*,*,*,*,縦断,ジュウダン,ジューダン
形成	名詞,サ変接続,*,*,*,*,形成,ケイセイ,ケイセイ
境	名詞,一般,*,*,*,*,境,サカイ,サカイ
ティレニア	名詞,固有名詞,一般,*,*,*,*
非常	名詞,形容動詞語幹,*,*,*,*,非常,ヒジョウ,ヒジョー
異なっ	動詞,自立,*,*,五段・ラ行,連用タ接続,異なる,コトナッ,コトナッ
寒冷	名詞,形容動詞語幹,*,*,*,*,寒冷,カンレイ,カンレイ
ボラ	名詞,一般,*,*,*,*,ボラ,ボラ,ボラ
冬	名詞,一般,*,*,*,*,冬,フユ,フユ
北東	名詞,一般,*,*,*,*,北東,ホクトウ,ホクトー
季節風	名詞,一般,*,*,*,*,季節風,キセツフウ,キセツフー
及ん	動詞,自立,*,*,五段・バ行,連用タ接続,及ぶ,オヨン,オヨン
冷たい	形容詞,自立,*,*,形容詞・アウオ段,基本形,冷たい,ツメタイ,ツメタイ
潮風	名詞,一般,*,*,*,*,潮風,シオカゼ,シオカゼ
吹き	動詞,自立,*,*,五段・カ行イ音便,連用形,吹く,フキ,フキ
つける	動詞,非自立,*,*,一段,基本形,つける,ツケル,ツケル
アブルッツォ	名詞,固有名詞,地域,一般,*,*,*
ラツィオ	名詞,固有名詞,地域,一般,*,*,*
しばしば	副詞,一般,*,*,*,*,しばしば,シバシバ,シバシバ
起こる	動詞,自立,*,*,五段・ラ行,基本形,起こる,オコル,オコル
ヴェスヴィオ	名詞,一般,*,*,*,*,*
有名	名詞,形容動詞語幹,*,*,*,*,有名,ユウメイ,ユーメイ
活火山	名詞,一般,*,*,*,*,活火山,カッカザン,カッカザン
噴火	名詞,サ変接続,*,*,*,*,噴火,フンカ,フンカ
時	名詞,一般,*,*,*,*,時,トキ,トキ
起こす	動詞,自立,*,*,五段・サ行,基本形,起こす,オコス,オコス
特別	名詞,形容動詞語幹,*,*,*,*,特別,トクベツ,トクベツ
危険	名詞,形容動詞語幹,*,*,*,*,危険,キケン,キケン
みなさ	動詞,自立,*,*,五段・サ行,未然形,みなす,ミナサ,ミナサ
おら	動詞,非自立,*,*,五段・ラ行,未然形,おる,オラ,オラ
数	名詞,数,*,*,*,*,数,スウ,スー
千	名詞,数,*,*,*,*,千,セン,セン
斜面	名詞,一般,*,*,*,*,斜面,シャメン,シャメン
麓	名詞,一般,*,*,*,*,麓,フモト,フモト
居住	名詞,サ変接続,*,*,*,*,居住,キョジュウ,キョジュー
多く	名詞,副詞可能,*,*,*,*,多く,オオク,オーク
川	名詞,一般,*,*,*,*,川,カワ,カワ
ポー川	名詞,固有名詞,一般,*,*,*,ポー川,ポーガワ,ポーガワ
アディジェ	名詞,固有名詞,地域,一般,*,*,*
テヴェレ	名詞,固有名詞,地域,一般,*,*,*
上位	名詞,一般,*,*,*,*,上位,ジョウイ,ジョーイ
長	形容詞,自立,*,*,形容詞・アウオ段,ガル接続,長い,ナガ,ナガ
アル	名詞,固有名詞,人名,名,*,*,アル,アル,アル
源流	名詞,一般,*,*,*,*,源流,ゲンリュウ,ゲンリュー
源	名詞,一般,*,*,*,*,源,ミナモト,ミナモト
発し	動詞,自立,*,*,五段・サ行,連用形,発す,ハッシ,ハッシ
市内	名詞,一般,*,*,*,*,市内,シナイ,シナイ
抜け	動詞,自立,*,*,一段,連用形,抜ける,ヌケ,ヌケ
流れる	動詞,自立,*,*,一段,基本形,流れる,ナガレル,ナガレル
区画	名詞,サ変接続,*,*,*,*,区画,クカク,クカク
県	名詞,一般,*,*,*,*,県,ケン,ケン
コムーネ	名詞,一般,*,*,*,*,*
郵便	名詞,一般,*,*,*,*,郵便,ユウビン,ユービン
最上	名詞,一般,*,*,*,*,最上,サイジョウ,サイジョー
単位	名詞,一般,*,*,*,*,単位,タンイ,タンイ
各州	名詞,一般,*,*,*,*,各州,カクシュウ,カクシュー
県	名詞,接尾,地域,*,*,*,県,ケン,ケン
分かれる	動詞,自立,*,*,一段,基本形,分かれる,ワカレル,ワカレル
市町村	名詞,一般,*,*,*,*,市町村,シチョウソン,シチョーソン
似	動詞,自立,*,*,一段,連用形,似る,ニ,ニ
ムニチーピオ	名詞,一般,*,*,*,*,*
州都	名詞,一般,*,*,*,*,州都,シュウト,シュート
主	名詞,接尾,一般,*,*,*,主,ヌシ,ヌシ
府	名詞,接尾,地域,*,*,*,府,フ,フ
本部	名詞,一般,*,*,*,*,本部,ホンブ,ホンブ
備考	名詞,一般,*,*,*,*,備考,ビコウ,ビコー
ピエモンテ	名詞,固有名詞,地域,一般,*,*,ピエモンテ,ピエモンテ,ピエモンテ
トリノ	名詞,固有名詞,地域,一般,*,*,トリノ,トリノ,トリノ
ヴァッレ・ダオスタ	名詞,固有名詞,地域,一般,*,*,*
自治	名詞,一般,*,*,*,*,自治,ジチ,ジチ
アオスタ	名詞,一般,*,*,*,*,*
同じ	連体詞,*,*,*,*,*,同じ,オナジ,オナジ
リグー	名詞,固有名詞,一般,*,*,*,リグー,リグー,リグー
リア	名詞,固有名詞,人名,名,*,*,リア,リア,リア
ロンバルディア	名詞,固有名詞,地域,一般,*,*,ロンバルディア,ロンバルディア,ロンバルディア
トレンティーノ	名詞,一般,*,*,*,*,*
＝	記号,一般,*,*,*,*,＝,＝,＝
アルト・アディジェ	名詞,固有名詞,地域,一般,*,*,*
トレント	名詞,一般,*,*,*,*,*
ヴェネト	名詞,固有名詞,地域,一般,*,*,*
フリ	名詞,一般,*,*,*,*,フリ,フリ,フリ
ウリ	名詞,一般,*,*,*,*,ウリ,ウリ,ウリ
ヴェネツィア・ジュリア	名詞,固有名詞,地域,一般,*,*,*
エミ	名詞,固有名詞,人名,名,*,*,エミ,エミ,エミ
ロマーニャ	名詞,固有名詞,地域,一般,*,*,*
ボローニャ	名詞,固有名詞,地域,一般,*,*,ボローニャ,ボローニャ,ボローニャ
トスカーナ	名詞,固有名詞,地域,一般,*,*,トスカーナ,トスカーナ,トスカーナ
ウンブリア	名詞,固有名詞,地域,一般,*,*,*
ペルー	名詞,固有名詞,地域,国,*,*,ペルー,ペルー,ペルー
ジャ	名詞,一般,*,*,*,*,ジャ,ジャ,ジャ
マルケ	名詞,固有名詞,地域,一般,*,*,*
アンコーナ	名詞,一般,*,*,*,*,*
ラクイラ	名詞,一般,*,*,*,*,*
モリーゼ	名詞,固有名詞,地域,一般,*,*,*
カンポバッソ	名詞,一般,*,*,*,*,*
カンパニア	名詞,固有名詞,地域,一般,*,*,*
ナポリ	名詞,固有名詞,地域,一般,*,*,ナポリ,ナポリ,ナポリ
プッリャ	名詞,固有名詞,地域,一般,*,*,*
バーリ	名詞,一般,*,*,*,*,*
バジリカータ	名詞,固有名詞,地域,一般,*,*,*
ポテンツァ	名詞,一般,*,*,*,*,*
カラブリア	名詞,固有名詞,地域,一般,*,*,*
カタンザーロ	名詞,一般,*,*,*,*,*
パレルモ	名詞,固有名詞,人名,姓,*,*,パレルモ,パレルモ,パレルモ
カリャリ	名詞,一般,*,*,*,*,*
メッシーナ	名詞,一般,*,*,*,*,*
パドヴァ	名詞,一般,*,*,*,*,*
ターラント	名詞,一般,*,*,*,*,*
ブレシア	名詞,一般,*,*,*,*,*
プラート	名詞,一般,*,*,*,*,*
レッジョ・ディ・カラブリア	名詞,一般,*,*,*,*,*
レッジョ・カラブリア	名詞,一般,*,*,*,*,*
カターニア	名詞,一般,*,*,*,*,*
モデナ	名詞,一般,*,*,*,*,*
国勢調査	名詞,一般,*,*,*,*,国勢調査,コクセイチョウサ,コクセイチョウサ
単一	名詞,一般,*,*,*,*,単一,タンイツ,タンイツ
市場	名詞,一般,*,*,*,*,市場,シジョウ,シジョー
土壌	名詞,一般,*,*,*,*,土壌,ドジョウ,ドジョー
高度	名詞,形容動詞語幹,*,*,*,*,高度,コウド,コード
差	名詞,接尾,一般,*,*,*,差,サ,サ
富ん	動詞,自立,*,*,五段・マ行,連用タ接続,富む,トン,トン
旧来	名詞,一般,*,*,*,*,旧来,キュウライ,キューライ
農作物	名詞,一般,*,*,*,*,農作物,ノウサクモツ,ノーサクモツ
栽培	名詞,サ変接続,*,*,*,*,栽培,サイバイ,サイバイ
全体	名詞,副詞可能,*,*,*,*,全体,ゼンタイ,ゼンタイ
小麦	名詞,一般,*,*,*,*,小麦,コムギ,コムギ
産	名詞,一般,*,*,*,*,産,サン,サン
沿岸	名詞,一般,*,*,*,*,沿岸,エンガン,エンガン
野菜	名詞,一般,*,*,*,*,野菜,ヤサイ,ヤサイ
果物	名詞,一般,*,*,*,*,果物,クダモノ,クダモノ
採れる	動詞,自立,*,*,一段,基本形,採れる,トレル,トレル
ワイン	名詞,一般,*,*,*,*,ワイン,ワイン,ワイン
オリーブ	名詞,一般,*,*,*,*,オリーブ,オリーブ,オリーブ
オイル	名詞,一般,*,*,*,*,オイル,オイル,オイル
量	名詞,接尾,一般,*,*,*,量,リョウ,リョウ
多い	形容詞,自立,*,*,形容詞・アウオ段,基本形,多い,オオイ,オーイ
酪農	名詞,一般,*,*,*,*,酪農,ラクノウ,ラクノー
ゴルゴンゾーラ	名詞,一般,*,*,*,*,*
パルミジャーノ・レッジャーノ	名詞,一般,*,*,*,*,*
種類	名詞,一般,*,*,*,*,種類,シュルイ,シュルイ
チーズ	名詞,一般,*,*,*,*,チーズ,チーズ,チーズ
工業	名詞,一般,*,*,*,*,工業,コウギョウ,コーギョー
急速	名詞,形容動詞語幹,*,*,*,*,急速,キュウソク,キューソク
転換	名詞,サ変接続,*,*,*,*,転換,テンカン,テンカン
繊維	名詞,一般,*,*,*,*,繊維,センイ,センイ
硫酸	名詞,一般,*,*,*,*,硫酸,リュウサン,リューサン
アンモニア	名詞,一般,*,*,*,*,アンモニア,アンモニア,アンモニア
水酸化	名詞,サ変接続,*,*,*,*,水酸化,スイサンカ,スイサンカ
ナトリウム	名詞,一般,*,*,*,*,ナトリウム,ナトリウム,ナトリューム
製造	名詞,サ変接続,*,*,*,*,製造,セイゾウ,セイゾー
化学	名詞,一般,*,*,*,*,化学,カガク,カガク
鉄鋼	名詞,一般,*,*,*,*,鉄鋼,テッコウ,テッコー
ゴム	名詞,一般,*,*,*,*,ゴム,ゴム,ゴム
重	接頭詞,名詞接続,*,*,*,*,重,ジュウ,ジュー
機械	名詞,一般,*,*,*,*,機械,キカイ,キカイ
家電	名詞,一般,*,*,*,*,家電,カデン,カデン
製品	名詞,一般,*,*,*,*,製品,セイヒン,セイヒン
パスタ	名詞,一般,*,*,*,*,パスタ,パスタ,パスタ
食料	名詞,一般,*,*,*,*,食料,ショクリョウ,ショクリョー
品	名詞,接尾,一般,*,*,*,品,ヒン,ヒン
業	名詞,接尾,一般,*,*,*,業,ギョウ,ギョー
にかけて	助詞,格助詞,連語,*,*,*,にかけて,ニカケテ,ニカケテ
年率	名詞,一般,*,*,*,*,年率,ネンリツ,ネンリツ
めざましい	形容詞,自立,*,*,形容詞・イ段,基本形,めざましい,メザマシイ,メザマシイ
遂げ	動詞,自立,*,*,一段,連用形,遂げる,トゲ,トゲ
紙	名詞,接尾,一般,*,*,*,紙,シ,シ
めざまし	形容詞,自立,*,*,形容詞・イ段,ガル接続,めざましい,メザマシ,メザマシ
指し	動詞,自立,*,*,五段・サ行,連用形,指す,サシ,サシ
奇跡	名詞,一般,*,*,*,*,奇跡,キセキ,キセキ
名付け	動詞,自立,*,*,一段,連用形,名付ける,ナヅケ,ナズケ
年代	名詞,接尾,助数詞,*,*,*,年代,ネンダイ,ネンダイ
圧迫	名詞,サ変接続,*,*,*,*,圧迫,アッパク,アッパク
膨大	名詞,形容動詞語幹,*,*,*,*,膨大,ボウダイ,ボーダイ
立て直し	動詞,自立,*,*,五段・サ行,連用形,立て直す,タテナオシ,タテナオシ
モンテディソン	名詞,一般,*,*,*,*,*
めぐる	動詞,自立,*,*,五段・ラ行,基本形,めぐる,メグル,メグル
混乱	名詞,サ変接続,*,*,*,*,混乱,コンラン,コンラン
限界	名詞,一般,*,*,*,*,限界,ゲンカイ,ゲンカイ
バブル	名詞,一般,*,*,*,*,バブル,バブル,バブル
牽引	名詞,サ変接続,*,*,*,*,牽引,ケンイン,ケンイン
担う	動詞,自立,*,*,五段・ワ行促音便,基本形,担う,ニナウ,ニナウ
巨大	名詞,形容動詞語幹,*,*,*,*,巨大,キョダイ,キョダイ
だっ	助動詞,*,*,*,特殊・ダ,連用タ接続,だ,ダッ,ダッ
抜き	動詞,自立,*,*,五段・カ行イ音便,連用形,抜く,ヌキ,ヌキ
また	副詞,助詞類接続,*,*,*,*,また,マタ,マタ
銀行	名詞,一般,*,*,*,*,銀行,ギンコウ,ギンコー
欧州共同体	名詞,固有名詞,組織,*,*,*,欧州共同体,オウシュウキョウドウタイ,オーシューキョードータイ
同調	名詞,サ変接続,*,*,*,*,同調,ドウチョウ,ドーチョー
大幅	名詞,形容動詞語幹,*,*,*,*,大幅,オオハバ,オーハバ
公営	名詞,一般,*,*,*,*,公営,コウエイ,コーエイ
資本	名詞,一般,*,*,*,*,資本,シホン,シホン
規制	名詞,サ変接続,*,*,*,*,規制,キセイ,キセイ
緩和	名詞,サ変接続,*,*,*,*,緩和,カンワ,カンワ
以後	名詞,副詞可能,*,*,*,*,以後,イゴ,イゴ
活性	名詞,一般,*,*,*,*,活性,カッセイ,カッセイ
研究	名詞,サ変接続,*,*,*,*,研究,ケンキュウ,ケンキュー
促進	名詞,サ変接続,*,*,*,*,促進,ソクシン,ソクシン
相場	名詞,一般,*,*,*,*,相場,ソウバ,ソーバ
リラ	名詞,一般,*,*,*,*,リラ,リラ,リラ
誘導	名詞,サ変接続,*,*,*,*,誘導,ユウドウ,ユードー
選択	名詞,サ変接続,*,*,*,*,選択,センタク,センタク
統合	名詞,サ変接続,*,*,*,*,統合,トウゴウ,トーゴー
陣	名詞,接尾,助数詞,*,*,*,陣,ジン,ジン
実現	名詞,サ変接続,*,*,*,*,実現,ジツゲン,ジツゲン
歳出	名詞,一般,*,*,*,*,歳出,サイシュツ,サイシュツ
策	名詞,接尾,一般,*,*,*,策,サク,サク
継続	名詞,サ変接続,*,*,*,*,継続,ケイゾク,ケイゾク
実施	名詞,サ変接続,*,*,*,*,実施,ジッシ,ジッシ
改善	名詞,サ変接続,*,*,*,*,改善,カイゼン,カイゼン
基準	名詞,一般,*,*,*,*,基準,キジュン,キジュン
達成	名詞,サ変接続,*,*,*,*,達成,タッセイ,タッセイ
半ば	名詞,副詞可能,*,*,*,*,半ば,ナカバ,ナカバ
公社	名詞,一般,*,*,*,*,公社,コウシャ,コーシャ
分解	名詞,サ変接続,*,*,*,*,分解,ブンカイ,ブンカイ
民営	名詞,一般,*,*,*,*,民営,ミンエイ,ミンエイ
リラ	名詞,接尾,助数詞,*,*,*,リラ,リラ,リラ
交換	名詞,サ変接続,*,*,*,*,交換,コウカン,コーカン
固定	名詞,サ変接続,*,*,*,*,固定,コテイ,コテイ
法定	名詞,一般,*,*,*,*,法定,ホウテイ,ホーテイ
長年	名詞,副詞可能,*,*,*,*,長年,ナガネン,ナガネン
使わ	動詞,自立,*,*,五段・ワ行促音便,未然形,使う,ツカワ,ツカワ
エウロ	名詞,一般,*,*,*,*,*
紙幣	名詞,一般,*,*,*,*,紙幣,シヘイ,シヘイ
硬貨	名詞,一般,*,*,*,*,硬貨,コウカ,コーカ
流通	名詞,サ変接続,*,*,*,*,流通,リュウツウ,リューツー
月末	名詞,副詞可能,*,*,*,*,月末,ゲツマツ,ゲツマツ
をもって	助詞,格助詞,連語,*,*,*,をもって,ヲモッテ,ヲモッテ
法的	名詞,形容動詞語幹,*,*,*,*,法的,ホウテキ,ホーテキ
効力	名詞,一般,*,*,*,*,効力,コウリョク,コーリョク
失っ	動詞,自立,*,*,五段・ワ行促音便,連用タ接続,失う,ウシナッ,ウシナッ
ソブリン	名詞,一般,*,*,*,*,*
危機	名詞,一般,*,*,*,*,危機,キキ,キキ
抑える	動詞,自立,*,*,一段,基本形,抑える,オサエル,オサエル
迫ら	動詞,自立,*,*,五段・ラ行,未然形,迫る,セマラ,セマラ
せる	動詞,接尾,*,*,一段,基本形,せる,セル,セル
裏	名詞,一般,*,*,*,*,裏,ウラ,ウラ
技	名詞,接尾,一般,*,*,*,技,ワザ,ワザ
麻薬	名詞,一般,*,*,*,*,麻薬,マヤク,マヤク
取引	名詞,サ変接続,*,*,*,*,取引,トリヒキ,トリヒキ
売春	名詞,サ変接続,*,*,*,*,売春,バイシュン,バイシュン
密輸	名詞,サ変接続,*,*,*,*,密輸,ミツユ,ミツユ
地下	名詞,一般,*,*,*,*,地下,チカ,チカ
着目	名詞,サ変接続,*,*,*,*,着目,チャクモク,チャクモク
統計	名詞,サ変接続,*,*,*,*,統計,トウケイ,トーケイ
加算	名詞,サ変接続,*,*,*,*,加算,カサン,カサン
推計	名詞,サ変接続,*,*,*,*,推計,スイケイ,スイケイ
森林	名詞,一般,*,*,*,*,森林,シンリン,シンリン
資源	名詞,一般,*,*,*,*,資源,シゲン,シゲン
乏しく	形容詞,自立,*,*,形容詞・イ段,連用テ接続,乏しい,トボシク,トボシク
木材	名詞,一般,*,*,*,*,木材,モクザイ,モクザイ
輸入	名詞,サ変接続,*,*,*,*,輸入,ユニュウ,ユニュー
頼っ	動詞,自立,*,*,五段・ラ行,連用タ接続,頼る,タヨッ,タヨッ
まず	副詞,一般,*,*,*,*,まず,マズ,マズ
伐採	名詞,サ変接続,*,*,*,*,伐採,バッサイ,バッサイ
それぞれ	名詞,副詞可能,*,*,*,*,それぞれ,ソレゾレ,ソレゾレ
目的	名詞,一般,*,*,*,*,目的,モクテキ,モクテキ
マラリア	名詞,一般,*,*,*,*,マラリア,マラリア,マラリア
防止	名詞,サ変接続,*,*,*,*,防止,ボウシ,ボーシ
浸食	名詞,サ変接続,*,*,*,*,浸食,シンショク,シンショク
進み	動詞,自立,*,*,五段・マ行,連用形,進む,ススミ,ススミ
林業	名詞,一般,*,*,*,*,林業,リンギョウ,リンギョー
障害	名詞,一般,*,*,*,*,障害,ショウガイ,ショーガイ
好転	名詞,サ変接続,*,*,*,*,好転,コウテン,コーテン
み	動詞,自立,*,*,一段,未然形,みる,ミ,ミ
現	接頭詞,名詞接続,*,*,*,*,現,ゲン,ゲン
増加	名詞,サ変接続,*,*,*,*,増加,ゾウカ,ゾーカ
石炭	名詞,一般,*,*,*,*,石炭,セキタン,セキタン
石油	名詞,一般,*,*,*,*,石油,セキユ,セキユ
原材料	名詞,一般,*,*,*,*,原材料,ゲンザイリョウ,ゲンザイリョー
依存	名詞,サ変接続,*,*,*,*,依存,イゾン,イゾン
切り下げ	名詞,サ変接続,*,*,*,*,切り下げ,キリサゲ,キリサゲ
価格	名詞,一般,*,*,*,*,価格,カカク,カカク
分の	名詞,接尾,助数詞,*,*,*,分の,ブンノ,ブンノ
おも	形容詞,自立,*,*,形容詞・アウオ段,ガル接続,おもい,オモ,オモ
な	助詞,終助詞,*,*,*,*,な,ナ,ナ
伍	名詞,サ変接続,*,*,*,*,伍,ゴ,ゴ
唯一	名詞,一般,*,*,*,*,唯一,ユイイツ,ユイイツ
過去	名詞,副詞可能,*,*,*,*,過去,カコ,カコ
割合	名詞,一般,*,*,*,*,割合,ワリアイ,ワリアイ
著しい	形容詞,自立,*,*,形容詞・イ段,基本形,著しい,イチジルシイ,イチジルシイ
アメリカ	名詞,固有名詞,地域,国,*,*,アメリカ,アメリカ,アメリカ
トルコ	名詞,固有名詞,地域,国,*,*,トルコ,トルコ,トルコ
ロシア	名詞,固有名詞,地域,国,*,*,ロシア,ロシア,ロシア
中国	名詞,固有名詞,地域,国,*,*,中国,チュウゴク,チューゴク
ガス	名詞,一般,*,*,*,*,ガス,ガス,ガス
発電	名詞,サ変接続,*,*,*,*,発電,ハツデン,ハツデン
天然	名詞,一般,*,*,*,*,天然,テンネン,テンネン
亜炭	名詞,一般,*,*,*,*,亜炭,アタン,アタン
用い	動詞,自立,*,*,一段,連用形,用いる,モチイ,モチイ
火力	名詞,一般,*,*,*,*,火力,カリョク,カリョク
生み出し	動詞,自立,*,*,五段・サ行,連用形,生み出す,ウミダシ,ウミダシ
水力	名詞,一般,*,*,*,*,水力,スイリョク,スイリョク
原子力	名詞,一般,*,*,*,*,原子力,ゲンシリョク,ゲンシリョク
技術	名詞,一般,*,*,*,*,技術,ギジュツ,ギジュツ
最先端	名詞,一般,*,*,*,*,最先端,サイセンタン,サイセンタン
時点	名詞,一般,*,*,*,*,時点,ジテン,ジテン
カ所	名詞,接尾,助数詞,*,*,*,カ所,カショ,カショ
所	名詞,接尾,一般,*,*,*,所,ショ,ショ
稼動	名詞,サ変接続,*,*,*,*,稼動,カドウ,カドー
しかしながら	接続詞,*,*,*,*,*,しかしながら,シカシナガラ,シカシナガラ
チェルノブイリ	名詞,固有名詞,地域,一般,*,*,チェルノブイリ,チェルノブイリ,チェルノブイリ
原発	名詞,一般,*,*,*,*,原発,ゲンパツ,ゲンパツ
きっかけ	名詞,一般,*,*,*,*,きっかけ,キッカケ,キッカケ
全面	名詞,一般,*,*,*,*,全面,ゼンメン,ゼンメン
停止	名詞,サ変接続,*,*,*,*,停止,テイシ,テイシ
運転	名詞,サ変接続,*,*,*,*,運転,ウンテン,ウンテン
再開	名詞,サ変接続,*,*,*,*,再開,サイカイ,サイカイ
決まっ	動詞,自立,*,*,五段・ラ行,連用タ接続,決まる,キマッ,キマッ
もっとも	副詞,一般,*,*,*,*,もっとも,モットモ,モットモ
売り上げ	名詞,一般,*,*,*,*,売り上げ,ウリアゲ,ウリアゲ
利益	名詞,一般,*,*,*,*,利益,リエキ,リエキ
スーパー	名詞,一般,*,*,*,*,スーパー,スーパー,スーパー
メジャー	名詞,一般,*,*,*,*,メジャー,メジャー,メジャー
電力	名詞,一般,*,*,*,*,電力,デンリョク,デンリョク
地熱	名詞,一般,*,*,*,*,地熱,チネツ,チネツ
蓄積	名詞,サ変接続,*,*,*,*,蓄積,チクセキ,チクセキ
戦前	名詞,一般,*,*,*,*,戦前,センゼン,センゼン
ウニクレディト	名詞,一般,*,*,*,*,*
依然として	副詞,一般,*,*,*,*,依然として,イゼントシテ,イゼントシテ
抱える	動詞,自立,*,*,一段,基本形,抱える,カカエル,カカエル
課題	名詞,一般,*,*,*,*,課題,カダイ,カダイ
遅れ	名詞,一般,*,*,*,*,遅れ,オクレ,オクレ
進ん	動詞,自立,*,*,五段・マ行,連用タ接続,進む,ススン,ススン
島嶼	名詞,一般,*,*,*,*,島嶼,トウショ,トーショ
観光	名詞,サ変接続,*,*,*,*,観光,カンコウ,カンコー
大きい	形容詞,自立,*,*,形容詞・イ段,基本形,大きい,オオキイ,オーキイ
遅れ	動詞,自立,*,*,一段,連用形,遅れる,オクレ,オクレ
半官半民	名詞,一般,*,*,*,*,半官半民,ハンカンハンミン,ハンカンハンミン
製鉄	名詞,サ変接続,*,*,*,*,製鉄,セイテツ,セイテツ
新た	名詞,形容動詞語幹,*,*,*,*,新た,アラタ,アラタ
育成	名詞,サ変接続,*,*,*,*,育成,イクセイ,イクセイ
努力	名詞,サ変接続,*,*,*,*,努力,ドリョク,ドリョク
労働	名詞,サ変接続,*,*,*,*,労働,ロウドウ,ロードー
問題	名詞,ナイ形容詞語幹,*,*,*,*,問題,モンダイ,モンダイ
結び	名詞,一般,*,*,*,*,結び,ムスビ,ムスビ
成り立っ	動詞,自立,*,*,五段・タ行,連用タ接続,成り立つ,ナリタッ,ナリタッ
進出	名詞,サ変接続,*,*,*,*,進出,シンシュツ,シンシュツ
阻ま	動詞,自立,*,*,五段・マ行,未然形,阻む,ハバマ,ハバマ
複雑	名詞,形容動詞語幹,*,*,*,*,複雑,フクザツ,フクザツ
現実	名詞,一般,*,*,*,*,現実,ゲンジツ,ゲンジツ
直面	名詞,サ変接続,*,*,*,*,直面,チョクメン,チョクメン
職	名詞,一般,*,*,*,*,職,ショク,ショク
求め	動詞,自立,*,*,一段,連用形,求める,モトメ,モトメ
移民	名詞,サ変接続,*,*,*,*,移民,イミン,イミン
耕作	名詞,サ変接続,*,*,*,*,耕作,コウサク,コーサク
放棄	名詞,サ変接続,*,*,*,*,放棄,ホウキ,ホーキ
一時期	名詞,副詞可能,*,*,*,*,一時期,イチジキ,イチジキ
ルーマニア	名詞,固有名詞,地域,国,*,*,ルーマニア,ルーマニア,ルーマニア
ポーランド	名詞,固有名詞,地域,国,*,*,ポーランド,ポーランド,ポーランド
中東	名詞,固有名詞,地域,一般,*,*,中東,チュウトウ,チュートー
系	名詞,接尾,一般,*,*,*,系,ケイ,ケイ
言及	名詞,サ変接続,*,*,*,*,言及,ゲンキュウ,ゲンキュー
少なく	形容詞,自立,*,*,形容詞・アウオ段,連用テ接続,少ない,スクナク,スクナク
乏しい	形容詞,自立,*,*,形容詞・イ段,基本形,乏しい,トボシイ,トボシイ
州	名詞,接尾,助数詞,*,*,*,州,シュウ,シュー
ヴァッレ・ダオスタ	名詞,一般,*,*,*,*,*
アルト・アディジェ	名詞,一般,*,*,*,*,*
ヴェネツィア・ジュリア	名詞,一般,*,*,*,*,*
匹敵	名詞,サ変接続,*,*,*,*,匹敵,ヒッテキ,ヒッテキ
対する	動詞,自立,*,*,サ変・－スル,基本形,対する,タイスル,タイスル
プーリア	名詞,固有名詞,地域,一般,*,*,*
除い	動詞,自立,*,*,五段・カ行イ音便,連用タ接続,除く,ノゾイ,ノゾイ
後進	名詞,サ変接続,*,*,*,*,後進,コウシン,コーシン
程度	名詞,一般,*,*,*,*,程度,テイド,テイド
水準	名詞,一般,*,*,*,*,水準,スイジュン,スイジュン
抜け出せ	動詞,自立,*,*,一段,連用形,抜け出せる,ヌケダセ,ヌケダセ
豊か	名詞,形容動詞語幹,*,*,*,*,豊か,ユタカ,ユタカ
持ち	動詞,自立,*,*,五段・タ行,連用形,持つ,モチ,モチ
明暗	名詞,一般,*,*,*,*,明暗,メイアン,メイアン
はっきり	副詞,助詞類接続,*,*,*,*,はっきり,ハッキリ,ハッキリ
分かれ	動詞,自立,*,*,一段,連用形,分かれる,ワカレ,ワカレ
に対して	助詞,格助詞,連語,*,*,*,に対して,ニタイシテ,ニタイシテ
悪影響	名詞,一般,*,*,*,*,悪影響,アクエイキョウ,アクエイキョー
いまだ	副詞,助詞類接続,*,*,*,*,いまだ,イマダ,イマダ
根強い	形容詞,自立,*,*,形容詞・アウオ段,基本形,根強い,ネヅヨイ,ネズヨイ
フィアット・	名詞,一般,*,*,*,*,*
のぼる	動詞,自立,*,*,五段・ラ行,基本形,のぼる,ノボル,ノボル
コンパクト	名詞,形容動詞語幹,*,*,*,*,コンパクト,コンパクト,コンパクト
カー	名詞,一般,*,*,*,*,カー,カー,カー
エコノミー	名詞,一般,*,*,*,*,エコノミー,エコノミー,エコノミー
再生	名詞,サ変接続,*,*,*,*,再生,サイセイ,サイセイ
エコ	名詞,一般,*,*,*,*,エコ,エコ,エコ
ロジカル	名詞,形容動詞語幹,*,*,*,*,ロジカル,ロジカル,ロジカル
売れ行き	名詞,一般,*,*,*,*,売れ行き,ウレユキ,ウレユキ
伸び	動詞,自立,*,*,一段,連用形,伸びる,ノビ,ノビ
車	名詞,接尾,一般,*,*,*,車,シャ,シャ
売上	名詞,一般,*,*,*,*,売上,ウリアゲ,ウリアゲ
高	名詞,接尾,一般,*,*,*,高,ダカ,ダカ
円	名詞,接尾,助数詞,*,*,*,円,エン,エン
要因	名詞,一般,*,*,*,*,要因,ヨウイン,ヨーイン
伸び悩ん	動詞,自立,*,*,五段・マ行,連用タ接続,伸び悩む,ノビナヤン,ノビナヤン
クライスラー	名詞,固有名詞,組織,*,*,*,クライスラー,クライスラー,クライスラー
ゼネラルモーターズ	名詞,一般,*,*,*,*,*
提携	名詞,サ変接続,*,*,*,*,提携,テイケイ,テイケイ
フェラーリ	名詞,固有名詞,組織,*,*,*,フェラーリ,フェラーリ,フェラーリ
ランボルギーニ	名詞,一般,*,*,*,*,*
アルファロメオ	名詞,一般,*,*,*,*,*
フィアット・パンダ	名詞,一般,*,*,*,*,*
新車	名詞,一般,*,*,*,*,新車,シンシャ,シンシャ
登録	名詞,サ変接続,*,*,*,*,登録,トウロク,トーロク
台数	名詞,一般,*,*,*,*,台数,ダイスウ,ダイスー
台	名詞,接尾,助数詞,*,*,*,台,ダイ,ダイ
フォルクスワーゲン	名詞,固有名詞,組織,*,*,*,フォルクスワーゲン,フォルクスワーゲン,フォルクスワーゲン
ポロ	名詞,一般,*,*,*,*,ポロ,ポロ,ポロ
ジョルジオ・アルマーニ	名詞,一般,*,*,*,*,*
服飾	名詞,一般,*,*,*,*,服飾,フクショク,フクショク
装飾	名詞,サ変接続,*,*,*,*,装飾,ソウショク,ソーショク
ブランド	名詞,一般,*,*,*,*,ブランド,ブランド,ブランド
ベネトン	名詞,固有名詞,組織,*,*,*,ベネトン,ベネトン,ベネトン
プラダ	名詞,一般,*,*,*,*,*
グッチ	名詞,固有名詞,組織,*,*,*,グッチ,グッチ,グッチ
ジャンニ・ヴェルサーチ	名詞,一般,*,*,*,*,*
ジャンフランコ・フェレ	名詞,一般,*,*,*,*,*
バレンチノ	名詞,一般,*,*,*,*,*
靴	名詞,一般,*,*,*,*,靴,クツ,クツ
サルヴァトーレ・フェラガモ	名詞,一般,*,*,*,*,*
トッズ	名詞,一般,*,*,*,*,*
宝飾	名詞,一般,*,*,*,*,宝飾,ホウショク,ホーショク
ブルガリ	名詞,一般,*,*,*,*,*
幼稚園	名詞,一般,*,*,*,*,幼稚園,ヨウチエン,ヨーチエン
先端	名詞,一般,*,*,*,*,先端,センタン,センタン
アトリエリスタ	名詞,一般,*,*,*,*,*
工芸	名詞,一般,*,*,*,*,工芸,コウゲイ,コーゲイ
専門	名詞,一般,*,*,*,*,専門,センモン,センモン
配置	名詞,サ変接続,*,*,*,*,配置,ハイチ,ハイチ
ヴァイオリン	名詞,一般,*,*,*,*,ヴァイオリン,ヴァイオリン,バイオリン
楽器	名詞,一般,*,*,*,*,楽器,ガッキ,ガッキ
ガラス	名詞,一般,*,*,*,*,ガラス,ガラス,ガラス
細工	名詞,接尾,一般,*,*,*,細工,ザイク,ザイク
なら	動詞,自立,*,*,五段・ラ行,未然形,なる,ナラ,ナラ
世界中	名詞,一般,*,*,*,*,世界中,セカイジュウ,セカイジュー
作ら	動詞,自立,*,*,五段・ラ行,未然形,作る,ツクラ,ツクラ
公開	名詞,サ変接続,*,*,*,*,公開,コウカイ,コーカイ
それら	名詞,代名詞,一般,*,*,*,それら,ソレラ,ソレラ
評価	名詞,サ変接続,*,*,*,*,評価,ヒョウカ,ヒョーカ
客	名詞,一般,*,*,*,*,客,キャク,キャク
到着	名詞,サ変接続,*,*,*,*,到着,トウチャク,トーチャク
数	名詞,接尾,一般,*,*,*,数,スウ,スー
フォーラム	名詞,一般,*,*,*,*,フォーラム,フォーラム,フォーラム
競争	名詞,サ変接続,*,*,*,*,競争,キョウソウ,キョーソー
レポート	名詞,サ変接続,*,*,*,*,レポート,レポート,レポート
か国	名詞,接尾,助数詞,*,*,*,か国,カコク,カコク
アッピア	名詞,一般,*,*,*,*,*
街道	名詞,一般,*,*,*,*,街道,カイドウ,カイドー
アウトストラーダ	名詞,一般,*,*,*,*,*
高速	名詞,一般,*,*,*,*,高速,コウソク,コーソク
図	名詞,一般,*,*,*,*,図,ズ,ズ
地中	名詞,一般,*,*,*,*,地中,チチュウ,チチュー
海域	名詞,一般,*,*,*,*,海域,カイイキ,カイイキ
要衝	名詞,一般,*,*,*,*,要衝,ヨウショウ,ヨーショー
頃	名詞,非自立,副詞可能,*,*,*,頃,コロ,コロ
歴代	名詞,一般,*,*,*,*,歴代,レキダイ,レキダイ
執政	名詞,一般,*,*,*,*,執政,シッセイ,シッセイ
官	名詞,接尾,一般,*,*,*,官,カン,カン
整備	名詞,サ変接続,*,*,*,*,整備,セイビ,セイビ
史跡	名詞,一般,*,*,*,*,史跡,シセキ,シセキ
残っ	動詞,自立,*,*,五段・ラ行,連用タ接続,残る,ノコッ,ノコッ
道	名詞,一般,*,*,*,*,道,ミチ,ミチ
通ず	動詞,自立,*,*,サ変・－ズル,文語基本形,通ずる,ツウズ,ツーズ
さえ	助詞,係助詞,*,*,*,*,さえ,サエ,サエ
新	接頭詞,名詞接続,*,*,*,*,新,シン,シン
発見	名詞,サ変接続,*,*,*,*,発見,ハッケン,ハッケン
有料	名詞,一般,*,*,*,*,有料,ユウリョウ,ユーリョー
網	名詞,接尾,一般,*,*,*,網,モウ,モー
はじめ	動詞,非自立,*,*,一段,連用形,はじめる,ハジメ,ハジメ
バックアップ	名詞,サ変接続,*,*,*,*,バックアップ,バックアップ,バックアップ
全土	名詞,一般,*,*,*,*,全土,ゼンド,ゼンド
敷き詰め	動詞,自立,*,*,一段,未然形,敷き詰める,シキツメ,シキツメ
ただし	接続詞,*,*,*,*,*,ただし,タダシ,タダシ
車	名詞,一般,*,*,*,*,車,クルマ,クルマ
言い	動詞,自立,*,*,五段・ワ行促音便,連用形,言う,イイ,イイ
切れ	動詞,非自立,*,*,一段,未然形,切れる,キレ,キレ
在	接頭詞,名詞接続,*,*,*,*,在,ザイ,ザイ
日本国	名詞,固有名詞,地域,国,*,*,日本国,ニッポンコク,ニッポンコク
総領事館	名詞,一般,*,*,*,*,総領事館,ソウリョウジカン,ソーリョージカン
手	名詞,接尾,一般,*,*,*,手,シュ,シュ
マナー	名詞,一般,*,*,*,*,マナー,マナー,マナー
自己	名詞,一般,*,*,*,*,自己,ジコ,ジコ
ルール	名詞,一般,*,*,*,*,ルール,ルール,ルール
て	動詞,非自立,*,*,一段,未然形,てる,テ,テ
比較	名詞,サ変接続,*,*,*,*,比較,ヒカク,ヒカク
はるか	名詞,形容動詞語幹,*,*,*,*,はるか,ハルカ,ハルカ
フェッロヴィーエ・デッロ・スタート	名詞,一般,*,*,*,*,*
トレニタリア	名詞,一般,*,*,*,*,*
国鉄	名詞,固有名詞,組織,*,*,*,国鉄,コクテツ,コクテツ
業務	名詞,一般,*,*,*,*,業務,ギョウム,ギョーム
引き継ぐ	動詞,自立,*,*,五段・ガ行,基本形,引き継ぐ,ヒキツグ,ヒキツグ
網羅	名詞,サ変接続,*,*,*,*,網羅,モウラ,モーラ
新	名詞,接尾,一般,*,*,*,新,シン,シン
ディレティッシマ	名詞,固有名詞,一般,*,*,*,*
列車	名詞,一般,*,*,*,*,列車,レッシャ,レッシャ
以外	名詞,非自立,副詞可能,*,*,*,以外,イガイ,イガイ
ヌオーヴォ・トラスポルト・ヴィアッジャトーリ	名詞,一般,*,*,*,*,*
チルクムヴェスヴィアーナ	名詞,一般,*,*,*,*,*
スッド・エスト	名詞,一般,*,*,*,*,*
地下鉄	名詞,一般,*,*,*,*,地下鉄,チカテツ,チカテツ
路面	名詞,一般,*,*,*,*,路面,ロメン,ロメン
ケーブルカー	名詞,一般,*,*,*,*,ケーブルカー,ケーブルカー,ケーブルカー
足	名詞,一般,*,*,*,*,足,アシ,アシ
要所	名詞,一般,*,*,*,*,要所,ヨウショ,ヨーショ
地	名詞,一般,*,*,*,*,地,チ,チ
クルーズ	名詞,一般,*,*,*,*,クルーズ,クルーズ,クルーズ
拠点	名詞,一般,*,*,*,*,拠点,キョテン,キョテン
ブリンディジ	名詞,固有名詞,一般,*,*,*,*
アリタ	名詞,固有名詞,組織,*,*,*,アリタ,アリタ,アリタ
航空	名詞,一般,*,*,*,*,航空,コウクウ,コークー
型	名詞,接尾,助数詞,*,*,*,型,ガタ,ガタ
空港	名詞,一般,*,*,*,*,空港,クウコウ,クーコー
株主	名詞,一般,*,*,*,*,株主,カブヌシ,カブヌシ
フラッグ	名詞,一般,*,*,*,*,フラッグ,フラッグ,フラッグ
キャリア	名詞,一般,*,*,*,*,キャリア,キャリア,キャリア
国内線	名詞,一般,*,*,*,*,国内線,コクナイセン,コクナイセン
域内	名詞,一般,*,*,*,*,域内,イキナイ,イキナイ
中	接頭詞,名詞接続,*,*,*,*,中,チュウ,チュー
長距離	名詞,一般,*,*,*,*,長距離,チョウキョリ,チョーキョリ
国際線	名詞,一般,*,*,*,*,国際線,コクサイセン,コクサイセン
運航	名詞,サ変接続,*,*,*,*,運航,ウンコウ,ウンコー
本拠地	名詞,一般,*,*,*,*,本拠地,ホンキョチ,ホンキョチ
メリディアーナ	名詞,一般,*,*,*,*,*
エア・ドロミティ	名詞,一般,*,*,*,*,*
東京	名詞,固有名詞,地域,一般,*,*,東京,トウキョウ,トーキョー
成田	名詞,固有名詞,地域,一般,*,*,成田,ナリタ,ナリタ
直行	名詞,サ変接続,*,*,*,*,直行,チョッコウ,チョッコー
便	名詞,接尾,一般,*,*,*,便,ビン,ビン
アムステルダム	名詞,固有名詞,地域,一般,*,*,アムステルダム,アムステルダム,アムステルダム
チューリッヒ	名詞,一般,*,*,*,*,*
バンコク	名詞,固有名詞,地域,一般,*,*,バンコク,バンコク,バンコク
香港	名詞,固有名詞,地域,一般,*,*,香港,ホンコン,ホンコン
ドバイ	名詞,固有名詞,地域,一般,*,*,ドバイ,ドバイ,ドバイ
経由	名詞,サ変接続,*,*,*,*,経由,ケイユ,ケイユ
行く	動詞,自立,*,*,五段・カ行促音便,基本形,行く,イク,イク
少子	名詞,一般,*,*,*,*,少子,ショウシ,ショーシ
高齢	名詞,一般,*,*,*,*,高齢,コウレイ,コーレイ
支える	動詞,自立,*,*,一段,基本形,支える,ササエル,ササエル
突入	名詞,サ変接続,*,*,*,*,突入,トツニュウ,トツニュー
次に	接続詞,*,*,*,*,*,次に,ツギニ,ツギニ
進行	名詞,サ変接続,*,*,*,*,進行,シンコウ,シンコー
その他	名詞,代名詞,一般,*,*,*,その他,ソノタ,ソノタ
ピラミッド	名詞,一般,*,*,*,*,ピラミッド,ピラミッド,ピラミッド
祖先	名詞,一般,*,*,*,*,祖先,ソセン,ソセン
主流	名詞,形容動詞語幹,*,*,*,*,主流,シュリュウ,シュリュー
ロマンス	名詞,一般,*,*,*,*,ロマンス,ロマンス,ロマンス
諸語	名詞,一般,*,*,*,*,諸語,ショゴ,ショゴ
属する	動詞,自立,*,*,サ変・－スル,基本形,属する,ゾクスル,ゾクスル
ラテン	名詞,一般,*,*,*,*,ラテン,ラテン,ラテン
考え	動詞,自立,*,*,一段,未然形,考える,カンガエ,カンガエ
単純	名詞,形容動詞語幹,*,*,*,*,単純,タンジュン,タンジュン
ラテン	名詞,固有名詞,地域,一般,*,*,ラテン,ラテン,ラテン
イタリック	名詞,一般,*,*,*,*,イタリック,イタリック,イタリック
ケルト	名詞,固有名詞,地域,一般,*,*,ケルト,ケルト,ケルト
ゲル	名詞,一般,*,*,*,*,ゲル,ゲル,ゲル
マン	名詞,一般,*,*,*,*,マン,マン,マン
多様	名詞,形容動詞語幹,*,*,*,*,多様,タヨウ,タヨー
関わり	名詞,一般,*,*,*,*,関わり,カカワリ,カカワリ
標準	名詞,一般,*,*,*,*,標準,ヒョウジュン,ヒョージュン
制定	名詞,サ変接続,*,*,*,*,制定,セイテイ,セイテイ
初等	名詞,一般,*,*,*,*,初等,ショトウ,ショトー
普及	名詞,サ変接続,*,*,*,*,普及,フキュウ,フキュー
均一	名詞,形容動詞語幹,*,*,*,*,均一,キンイツ,キンイツ
段階	名詞,一般,*,*,*,*,段階,ダンカイ,ダンカイ
意識	名詞,サ変接続,*,*,*,*,意識,イシキ,イシキ
浸透	名詞,サ変接続,*,*,*,*,浸透,シントウ,シントー
高まり	名詞,一般,*,*,*,*,高まり,タカマリ,タカマリ
未	接頭詞,名詞接続,*,*,*,*,未,ミ,ミ
回収	名詞,サ変接続,*,*,*,*,回収,カイシュウ,カイシュー
求める	動詞,自立,*,*,一段,基本形,求める,モトメル,モトメル
生み	動詞,自立,*,*,五段・マ行,連用形,生む,ウミ,ウミ
イレデンティズム	名詞,一般,*,*,*,*,*
語源	名詞,一般,*,*,*,*,語源,ゴゲン,ゴゲン
高まっ	動詞,自立,*,*,五段・ラ行,連用タ接続,高まる,タカマッ,タカマッ
国粋	名詞,一般,*,*,*,*,国粋,コクスイ,コクスイ
高揚	名詞,サ変接続,*,*,*,*,高揚,コウヨウ,コーヨー
流れ	名詞,一般,*,*,*,*,流れ,ナガレ,ナガレ
最終	名詞,一般,*,*,*,*,最終,サイシュウ,サイシュー
にわたって	助詞,格助詞,連語,*,*,*,にわたって,ニワタッテ,ニワタッテ
続く	動詞,自立,*,*,五段・カ行イ音便,基本形,続く,ツヅク,ツズク
浄化	名詞,サ変接続,*,*,*,*,浄化,ジョウカ,ジョーカ
推進	名詞,サ変接続,*,*,*,*,推進,スイシン,スイシン
チロル	名詞,固有名詞,地域,一般,*,*,チロル,チロル,チロル
挙げ	動詞,自立,*,*,一段,未然形,挙げる,アゲ,アゲ
イストリア	名詞,一般,*,*,*,*,*
スラブ	名詞,固有名詞,地域,一般,*,*,スラブ,スラブ,スラブ
住民	名詞,一般,*,*,*,*,住民,ジュウミン,ジューミン
上記	名詞,一般,*,*,*,*,上記,ジョウキ,ジョーキ
通り	名詞,一般,*,*,*,*,通り,トオリ,トーリ
下	名詞,接尾,一般,*,*,*,下,カ,カ
徹底	名詞,サ変接続,*,*,*,*,徹底,テッテイ,テッテイ
弾圧	名詞,サ変接続,*,*,*,*,弾圧,ダンアツ,ダンアツ
一定	名詞,サ変接続,*,*,*,*,一定,イッテイ,イッテイ
以来	名詞,副詞可能,*,*,*,*,以来,イライ,イライ
集権	名詞,一般,*,*,*,*,集権,シュウケン,シューケン
要素	名詞,一般,*,*,*,*,要素,ヨウソ,ヨーソ
流入	名詞,サ変接続,*,*,*,*,流入,リュウニュウ,リューニュー
続き	動詞,自立,*,*,五段・カ行イ音便,連用形,続く,ツヅキ,ツズキ
失業	名詞,サ変接続,*,*,*,*,失業,シツギョウ,シツギョー
貧困	名詞,一般,*,*,*,*,貧困,ヒンコン,ヒンコン
生活	名詞,サ変接続,*,*,*,*,生活,セイカツ,セイカツ
習慣	名詞,一般,*,*,*,*,習慣,シュウカン,シューカン
軋轢	名詞,一般,*,*,*,*,軋轢,アツレキ,アツレキ
引き起こし	動詞,自立,*,*,五段・サ行,連用形,引き起こす,ヒキオコシ,ヒキオコシ
及ば	動詞,自立,*,*,五段・バ行,未然形,及ぶ,オヨバ,オヨバ
数え	動詞,自立,*,*,一段,連用形,数える,カゾエ,カゾエ
割	名詞,接尾,助数詞,*,*,*,割,ワリ,ワリ
達し	動詞,自立,*,*,五段・サ行,連用形,達す,タッシ,タッシ
定着	名詞,サ変接続,*,*,*,*,定着,テイチャク,テイチャク
批判	名詞,サ変接続,*,*,*,*,批判,ヒハン,ヒハン
越え	動詞,自立,*,*,一段,連用形,越える,コエ,コエ
訪れる	動詞,自立,*,*,一段,基本形,訪れる,オトズレル,オトズレル
モロッコ	名詞,固有名詞,地域,国,*,*,モロッコ,モロッコ,モロッコ
華人	名詞,一般,*,*,*,*,華人,カジン,カジン
倍	名詞,一般,*,*,*,*,倍,バイ,バイ
アラブ	名詞,固有名詞,地域,一般,*,*,アラブ,アラブ,アラブ
春	名詞,一般,*,*,*,*,春,ハル,ハル
シリア	名詞,固有名詞,地域,国,*,*,シリア,シリア,シリア
内戦	名詞,一般,*,*,*,*,内戦,ナイセン,ナイセン
台頭	名詞,サ変接続,*,*,*,*,台頭,タイトウ,タイトー
海路	名詞,一般,*,*,*,*,海路,カイロ,カイロ
不法	名詞,一般,*,*,*,*,不法,フホウ,フホー
上陸	名詞,サ変接続,*,*,*,*,上陸,ジョウリク,ジョーリク
急増	名詞,サ変接続,*,*,*,*,急増,キュウゾウ,キューゾー
ソマリア	名詞,固有名詞,地域,国,*,*,ソマリア,ソマリア,ソマリア
エリトリア	名詞,固有名詞,地域,国,*,*,エリトリア,エリトリア,エリトリア
おもに	副詞,一般,*,*,*,*,おもに,オモニ,オモニ
載せ	動詞,自立,*,*,一段,連用形,載せる,ノセ,ノセ
船	名詞,一般,*,*,*,*,船,フネ,フネ
沈没	名詞,サ変接続,*,*,*,*,沈没,チンボツ,チンボツ
死亡	名詞,サ変接続,*,*,*,*,死亡,シボウ,シボー
救助	名詞,サ変接続,*,*,*,*,救助,キュウジョ,キュージョ
力	名詞,一般,*,*,*,*,力,チカラ,チカラ
入れ	動詞,自立,*,*,一段,連用形,入れる,イレ,イレ
反感	名詞,一般,*,*,*,*,反感,ハンカン,ハンカン
エスノローグ	名詞,一般,*,*,*,*,*
調査	名詞,サ変接続,*,*,*,*,調査,チョウサ,チョーサ
うち	名詞,非自立,副詞可能,*,*,*,うち,ウチ,ウチ
母国	名詞,一般,*,*,*,*,母国,ボコク,ボコク
圏内	名詞,一般,*,*,*,*,圏内,ケンナイ,ケンナイ
等	名詞,接尾,一般,*,*,*,等,トウ,トー
ラ・スペツィア	名詞,一般,*,*,*,*,*
リミニ	名詞,一般,*,*,*,*,*
線	名詞,一般,*,*,*,*,線,セン,セン
ロ	名詞,固有名詞,組織,*,*,*,ロ,ロ,ロ
マニア	名詞,一般,*,*,*,*,マニア,マニア,マニア
側	名詞,一般,*,*,*,*,側,ガワ,ガワ
言葉	名詞,一般,*,*,*,*,言葉,コトバ,コトバ
異なる	動詞,自立,*,*,五段・ラ行,基本形,異なる,コトナル,コトナル
分類	名詞,サ変接続,*,*,*,*,分類,ブンルイ,ブンルイ
ガロ	名詞,固有名詞,一般,*,*,*,ガロ,ガロ,ガロ
別	名詞,一般,*,*,*,*,別,ベツ,ベツ
差	名詞,一般,*,*,*,*,差,サ,サ
激しい	形容詞,自立,*,*,形容詞・イ段,基本形,激しい,ハゲシイ,ハゲシイ
そもそも	接続詞,*,*,*,*,*,そもそも,ソモソモ,ソモソモ
過程	名詞,一般,*,*,*,*,過程,カテイ,カテイ
事情	名詞,一般,*,*,*,*,事情,ジジョウ,ジジョー
絡ん	動詞,自立,*,*,五段・マ行,連用タ接続,絡む,カラン,カラン
話さ	動詞,自立,*,*,五段・サ行,未然形,話す,ハナサ,ハナサ
ラテン語	名詞,一般,*,*,*,*,ラテン語,ラテンゴ,ラテンゴ
俗語	名詞,一般,*,*,*,*,俗語,ゾクゴ,ゾクゴ
形	名詞,接尾,一般,*,*,*,形,ガタ,ガタ
俗	名詞,一般,*,*,*,*,俗,ゾク,ゾク
消滅	名詞,サ変接続,*,*,*,*,消滅,ショウメツ,ショーメツ
際	名詞,非自立,副詞可能,*,*,*,際,サイ,サイ
特有	名詞,一般,*,*,*,*,特有,トクユウ,トクユー
ひとつ	名詞,副詞可能,*,*,*,*,ひとつ,ヒトツ,ヒトツ
体系	名詞,一般,*,*,*,*,体系,タイケイ,タイケイ
定め	動詞,自立,*,*,一段,連用形,定める,サダメ,サダメ
起因	名詞,サ変接続,*,*,*,*,起因,キイン,キイン
違い	名詞,ナイ形容詞語幹,*,*,*,*,違い,チガイ,チガイ
作業	名詞,サ変接続,*,*,*,*,作業,サギョウ,サギョー
学	名詞,接尾,一般,*,*,*,学,ガク,ガク
どの	連体詞,*,*,*,*,*,どの,ドノ,ドノ
もっ	動詞,自立,*,*,五段・タ行,連用タ接続,もつ,モッ,モッ
系統	名詞,一般,*,*,*,*,系統,ケイトウ,ケイトー
あるいは	接続詞,*,*,*,*,*,あるいは,アルイハ,アルイワ
客観	名詞,サ変接続,*,*,*,*,客観,キャッカン,キャッカン
ほとんど	副詞,一般,*,*,*,*,ほとんど,ホトンド,ホトンド
不可能	名詞,形容動詞語幹,*,*,*,*,不可能,フカノウ,フカノー
結局	名詞,副詞可能,*,*,*,*,結局,ケッキョク,ケッキョク
個々人	名詞,一般,*,*,*,*,個々人,ココジン,ココジン
価値	名詞,一般,*,*,*,*,価値,カチ,カチ
観	名詞,接尾,一般,*,*,*,観,カン,カン
頼る	動詞,自立,*,*,五段・ラ行,基本形,頼る,タヨル,タヨル
しか	助詞,係助詞,*,*,*,*,しか,シカ,シカ
なく	形容詞,自立,*,*,形容詞・アウオ段,連用テ接続,ない,ナク,ナク
主張	名詞,サ変接続,*,*,*,*,主張,シュチョウ,シュチョー
兼ね合い	名詞,一般,*,*,*,*,兼ね合い,カネアイ,カネアイ
下さ	動詞,自立,*,*,五段・サ行,未然形,下す,クダサ,クダサ
守ら	動詞,自立,*,*,五段・ラ行,未然形,守る,マモラ,マモラ
し	助動詞,*,*,*,文語・キ,体言接続,き,シ,シ
皮肉	名詞,形容動詞語幹,*,*,*,*,皮肉,ヒニク,ヒニク
よって	接続詞,*,*,*,*,*,よって,ヨッテ,ヨッテ
集合	名詞,サ変接続,*,*,*,*,集合,シュウゴウ,シューゴー
無数	名詞,一般,*,*,*,*,無数,ムスウ,ムスー
基づい	動詞,自立,*,*,五段・カ行イ音便,連用タ接続,基づく,モトヅイ,モトズイ
認める	動詞,自立,*,*,一段,基本形,認める,ミトメル,ミトメル
動き	名詞,一般,*,*,*,*,動き,ウゴキ,ウゴキ
芽生え	動詞,自立,*,*,一段,連用形,芽生える,メバエ,メバエ
始め	動詞,非自立,*,*,一段,連用形,始める,ハジメ,ハジメ
べき	助動詞,*,*,*,文語・ベシ,体言接続,べし,ベキ,ベキ
どう	副詞,助詞類接続,*,*,*,*,どう,ドウ,ドー
重ね	動詞,自立,*,*,一段,未然形,重ねる,カサネ,カサネ
現象	名詞,一般,*,*,*,*,現象,ゲンショウ,ゲンショー
経緯	名詞,一般,*,*,*,*,経緯,ケイイ,ケイイ
発生	名詞,サ変接続,*,*,*,*,発生,ハッセイ,ハッセイ
尊重	名詞,サ変接続,*,*,*,*,尊重,ソンチョウ,ソンチョー
権利	名詞,一般,*,*,*,*,権利,ケンリ,ケンリ
共和	名詞,固有名詞,組織,*,*,*,共和,キョウワ,キョーワ
認め	動詞,自立,*,*,一段,連用形,認める,ミトメ,ミトメ
ヴェネト	名詞,一般,*,*,*,*,*
ナポリ・カラブリア	名詞,一般,*,*,*,*,*
ティロル	名詞,一般,*,*,*,*,*
ラディン	名詞,一般,*,*,*,*,*
レト・ロマンス	名詞,一般,*,*,*,*,*
群	名詞,接尾,一般,*,*,*,群,グン,グン
母語	名詞,一般,*,*,*,*,母語,ボゴ,ボゴ
いる	動詞,自立,*,*,一段,基本形,いる,イル,イル
最	接頭詞,名詞接続,*,*,*,*,最,サイ,サイ
残す	動詞,自立,*,*,五段・サ行,基本形,残す,ノコス,ノコス
グリコ	名詞,固有名詞,組織,*,*,*,グリコ,グリコ,グリコ
話者	名詞,一般,*,*,*,*,話者,ワシャ,ワシャ
オスマン	名詞,固有名詞,人名,姓,*,*,オスマン,オスマン,オスマン
子孫	名詞,一般,*,*,*,*,子孫,シソン,シソン
一方	名詞,非自立,副詞可能,*,*,*,一方,イッポウ,イッポー
言	名詞,一般,*,*,*,*,言,ゲン,ゲン
アルゲーロ	名詞,一般,*,*,*,*,*
カタルーニャ	名詞,固有名詞,地域,一般,*,*,カタルーニャ,カタルーニャ,カタルーニャ
基本	名詞,一般,*,*,*,*,基本,キホン,キホン
夫婦	名詞,一般,*,*,*,*,夫婦,フウフ,フーフ
別姓	名詞,一般,*,*,*,*,別姓,ベッセイ,ベッセイ
結合	名詞,サ変接続,*,*,*,*,結合,ケツゴウ,ケツゴー
子	名詞,接尾,一般,*,*,*,子,コ,コ
に関して	助詞,格助詞,連語,*,*,*,に関して,ニカンシテ,ニカンシテ
父親	名詞,一般,*,*,*,*,父親,チチオヤ,チチオヤ
理由	名詞,一般,*,*,*,*,理由,リユウ,リユー
母親	名詞,一般,*,*,*,*,母親,ハハオヤ,ハハオヤ
よい	形容詞,非自立,*,*,形容詞・アウオ段,基本形,よい,ヨイ,ヨイ
通し	動詞,自立,*,*,五段・サ行,連用形,通す,トオシ,トーシ
きわめて	副詞,一般,*,*,*,*,きわめて,キワメテ,キワメテ
離婚	名詞,サ変接続,*,*,*,*,離婚,リコン,リコン
少ない	形容詞,自立,*,*,形容詞・アウオ段,基本形,少ない,スクナイ,スクナイ
端	名詞,接尾,一般,*,*,*,端,タン,タン
総本山	名詞,一般,*,*,*,*,総本山,ソウホンザン,ソーホンザン
サン・ピエトロ	名詞,一般,*,*,*,*,*
聖堂	名詞,一般,*,*,*,*,聖堂,セイドウ,セイドー
東方	名詞,一般,*,*,*,*,東方,トウホウ,トーホー
正教会	名詞,一般,*,*,*,*,正教会,セイキョウカイ,セイキョーカイ
オリエント	名詞,一般,*,*,*,*,オリエント,オリエント,オリエント
正教	名詞,一般,*,*,*,*,正教,セイキョウ,セイキョー
プロテスタント	名詞,固有名詞,一般,*,*,*,プロテスタント,プロテスタント,プロテスタント
諸派	名詞,一般,*,*,*,*,諸派,ショハ,ショハ
無	接頭詞,名詞接続,*,*,*,*,無,ム,ム
無神	名詞,一般,*,*,*,*,無神,ムシン,ムシン
論	名詞,接尾,一般,*,*,*,論,ロン,ロン
不可知論	名詞,一般,*,*,*,*,不可知論,フカチロン,フカチロン
推定	名詞,サ変接続,*,*,*,*,推定,スイテイ,スイテイ
残り	名詞,一般,*,*,*,*,残り,ノコリ,ノコリ
大半	名詞,一般,*,*,*,*,大半,タイハン,タイハン
または	接続詞,*,*,*,*,*,または,マタハ,マタワ
ムスリム	名詞,一般,*,*,*,*,*
未満	名詞,接尾,一般,*,*,*,未満,ミマン,ミマン
信条	名詞,一般,*,*,*,*,信条,シンジョウ,シンジョー
リベラル	名詞,一般,*,*,*,*,リベラル,リベラル,リベラル
教義	名詞,一般,*,*,*,*,教義,キョウギ,キョーギ
反し	動詞,自立,*,*,五段・サ行,連用形,反す,ハンシ,ハンシ
同棲	名詞,サ変接続,*,*,*,*,同棲,ドウセイ,ドーセイ
妊娠	名詞,サ変接続,*,*,*,*,妊娠,ニンシン,ニンシン
中絶	名詞,サ変接続,*,*,*,*,中絶,チュウゼツ,チューゼツ
肯定	名詞,サ変接続,*,*,*,*,肯定,コウテイ,コーテイ
報告	名詞,サ変接続,*,*,*,*,報告,ホウコク,ホーコク
出	動詞,自立,*,*,一段,連用形,出る,デ,デ
イスラム教	名詞,固有名詞,一般,*,*,*,イスラム教,イスラムキョウ,イスラムキョー
信教	名詞,一般,*,*,*,*,信教,シンキョウ,シンキョー
自由	名詞,形容動詞語幹,*,*,*,*,自由,ジユウ,ジユー
福祉	名詞,一般,*,*,*,*,福祉,フクシ,フクシ
税金	名詞,一般,*,*,*,*,税金,ゼイキン,ゼイキン
原資	名詞,一般,*,*,*,*,原資,ゲンシ,ゲンシ
ユニバーサル	名詞,一般,*,*,*,*,ユニバーサル,ユニバーサル,ユニバーサル
ヘルスケア	名詞,一般,*,*,*,*,ヘルスケア,ヘルスケア,ヘルスケア
施行	名詞,サ変接続,*,*,*,*,施行,シコウ,シコー
混合	名詞,サ変接続,*,*,*,*,混合,コンゴウ,コンゴー
公費	名詞,一般,*,*,*,*,公費,コウヒ,コーヒ
負担	名詞,サ変接続,*,*,*,*,負担,フタン,フタン
省	名詞,接尾,一般,*,*,*,省,ショウ,ショー
方針	名詞,一般,*,*,*,*,方針,ホウシン,ホーシン
現場	名詞,一般,*,*,*,*,現場,ゲンバ,ゲンバ
支出	名詞,サ変接続,*,*,*,*,支出,シシュツ,シシュツ
平均	名詞,サ変接続,*,*,*,*,平均,ヘイキン,ヘイキン
効率	名詞,一般,*,*,*,*,効率,コウリツ,コーリツ
評さ	動詞,自立,*,*,五段・サ行,未然形,評す,ヒョウサ,ヒョーサ
余命	名詞,一般,*,*,*,*,余命,ヨメイ,ヨメイ
健康	名詞,形容動詞語幹,*,*,*,*,健康,ケンコウ,ケンコー
リスク	名詞,一般,*,*,*,*,リスク,リスク,リスク
西欧	名詞,固有名詞,地域,一般,*,*,西欧,セイオウ,セイオー
肥満	名詞,サ変接続,*,*,*,*,肥満,ヒマン,ヒマン
増え	動詞,自立,*,*,一段,連用形,増える,フエ,フエ
太り	動詞,自立,*,*,五段・ラ行,連用形,太る,フトリ,フトリ
すぎ	動詞,非自立,*,*,一段,連用形,すぎる,スギ,スギ
申告	名詞,サ変接続,*,*,*,*,申告,シンコク,シンコク
だ	助動詞,*,*,*,特殊・ダ,基本形,だ,ダ,ダ
日常	名詞,一般,*,*,*,*,日常,ニチジョウ,ニチジョー
喫煙	名詞,サ変接続,*,*,*,*,喫煙,キツエン,キツエン
公共	名詞,一般,*,*,*,*,公共,コウキョウ,コーキョー
バー	名詞,一般,*,*,*,*,バー,バー,バー
ナイトクラブ	名詞,一般,*,*,*,*,ナイトクラブ,ナイトクラブ,ナイトクラブ
隔離	名詞,サ変接続,*,*,*,*,隔離,カクリ,カクリ
室	名詞,接尾,一般,*,*,*,室,シツ,シツ
設け	動詞,自立,*,*,一段,未然形,設ける,モウケ,モーケ
最も	副詞,一般,*,*,*,*,最も,モットモ,モットモ
不安定	名詞,形容動詞語幹,*,*,*,*,不安定,フアンテイ,フアンテイ
顕著	名詞,形容動詞語幹,*,*,*,*,顕著,ケンチョ,ケンチョ
取締り	名詞,サ変接続,*,*,*,*,取締り,トリシマリ,トリシマリ
ならびに	接続詞,*,*,*,*,*,ならびに,ナラビニ,ナラビニ
解消	名詞,サ変接続,*,*,*,*,解消,カイショウ,カイショー
取り組ん	動詞,自立,*,*,五段・マ行,連用タ接続,取り組む,トリクン,トリクン
甲斐	名詞,一般,*,*,*,*,甲斐,カイ,カイ
効果	名詞,一般,*,*,*,*,効果,コウカ,コーカ
現れ	動詞,自立,*,*,一段,連用形,現れる,アラワレ,アラワレ
来	動詞,非自立,*,*,カ変・来ル,連用形,来る,キ,キ
内務省	名詞,固有名詞,組織,*,*,*,内務省,ナイムショウ,ナイムショー
認知	名詞,サ変接続,*,*,*,*,認知,ニンチ,ニンチ
件数	名詞,一般,*,*,*,*,件数,ケンスウ,ケンスー
件	名詞,接尾,助数詞,*,*,*,件,ケン,ケン
前年	名詞,副詞可能,*,*,*,*,前年,ゼンネン,ゼンネン
減少	名詞,サ変接続,*,*,*,*,減少,ゲンショウ,ゲンショー
スリ	名詞,一般,*,*,*,*,スリ,スリ,スリ
．	名詞,数,*,*,*,*,．,．,．
減	名詞,接尾,一般,*,*,*,減,ゲン,ゲン
ひったくり	名詞,一般,*,*,*,*,ひったくり,ヒッタクリ,ヒッタクリ
滞在	名詞,サ変接続,*,*,*,*,滞在,タイザイ,タイザイ
用心	名詞,サ変接続,*,*,*,*,用心,ヨウジン,ヨージン
予防	名詞,サ変接続,*,*,*,*,予防,ヨボウ,ヨボー
来る	動詞,非自立,*,*,カ変・来ル,基本形,来る,クル,クル
被害	名詞,一般,*,*,*,*,被害,ヒガイ,ヒガイ
寄せ	動詞,自立,*,*,一段,未然形,寄せる,ヨセ,ヨセ
窃盗	名詞,サ変接続,*,*,*,*,窃盗,セットウ,セットー
荒らし	動詞,自立,*,*,五段・サ行,連用形,荒らす,アラシ,アラシ
置き引き	名詞,一般,*,*,*,*,置き引き,オキビキ,オキビキ
強盗	名詞,一般,*,*,*,*,強盗,ゴウトウ,ゴートー
睡眠薬	名詞,一般,*,*,*,*,睡眠薬,スイミンヤク,スイミンヤク
押し売り	名詞,サ変接続,*,*,*,*,押し売り,オシウリ,オシウリ
酒場	名詞,一般,*,*,*,*,酒場,サカバ,サカバ
ぼっ	動詞,自立,*,*,五段・ラ行,連用タ接続,ぼる,ボッ,ボッ
くり	名詞,一般,*,*,*,*,くり,クリ,クリ
警察官	名詞,一般,*,*,*,*,警察官,ケイサツカン,ケイサツカン
なりすまし	動詞,自立,*,*,五段・サ行,連用形,なりすます,ナリスマシ,ナリスマシ
偽札	名詞,一般,*,*,*,*,偽札,ニセサツ,ニセサツ
違法	名詞,形容動詞語幹,*,*,*,*,違法,イホウ,イホー
薬物	名詞,一般,*,*,*,*,薬物,ヤクブツ,ヤクブツ
捜査	名詞,サ変接続,*,*,*,*,捜査,ソウサ,ソーサ
称し	動詞,自立,*,*,五段・サ行,連用形,称す,ショウシ,ショーシ
所持	名詞,サ変接続,*,*,*,*,所持,ショジ,ショジ
検査	名詞,サ変接続,*,*,*,*,検査,ケンサ,ケンサ
装っ	動詞,自立,*,*,五段・ワ行促音便,連用タ接続,装う,ヨソオッ,ヨソオッ
現金	名詞,一般,*,*,*,*,現金,ゲンキン,ゲンキン
クレジットカード	名詞,一般,*,*,*,*,クレジットカード,クレジットカード,クレジットカード
窃取	名詞,サ変接続,*,*,*,*,窃取,セッシュ,セッシュ
相次い	動詞,自立,*,*,五段・ガ行,連用タ接続,相次ぐ,アイツイ,アイツイ
外出	名詞,サ変接続,*,*,*,*,外出,ガイシュツ,ガイシュツ
散策	名詞,サ変接続,*,*,*,*,散策,サンサク,サンサク
常に	副詞,一般,*,*,*,*,常に,ツネニ,ツネニ
警戒	名詞,サ変接続,*,*,*,*,警戒,ケイカイ,ケイカイ
強める	動詞,自立,*,*,一段,基本形,強める,ツヨメル,ツヨメル
姿勢	名詞,一般,*,*,*,*,姿勢,シセイ,シセイ
求め	動詞,自立,*,*,一段,未然形,求める,モトメ,モトメ
執行	名詞,サ変接続,*,*,*,*,執行,シッコウ,シッコー
複合	名詞,サ変接続,*,*,*,*,複合,フクゴウ,フクゴー
レベル	名詞,一般,*,*,*,*,レベル,レベル,レベル
つ	助動詞,*,*,*,下二・タ行,基本形,つ,ツ,ツ
自治体	名詞,一般,*,*,*,*,自治体,ジチタイ,ジチタイ
受ける	動詞,自立,*,*,一段,基本形,受ける,ウケル,ウケル
扱う	動詞,自立,*,*,五段・ワ行促音便,基本形,扱う,アツカウ,アツカウ
軽犯罪	名詞,一般,*,*,*,*,軽犯罪,ケイハンザイ,ケイハンザイ
事案	名詞,一般,*,*,*,*,事案,ジアン,ジアン
取り扱う	動詞,自立,*,*,五段・ワ行促音便,基本形,取り扱う,トリアツカウ,トリアツカウ
財務	名詞,一般,*,*,*,*,財務,ザイム,ザイム
財務省	名詞,固有名詞,組織,*,*,*,財務省,ザイムショウ,ザイムショー
脱税	名詞,サ変接続,*,*,*,*,脱税,ダツゼイ,ダツゼイ
知的	名詞,一般,*,*,*,*,知的,チテキ,チテキ
財産	名詞,一般,*,*,*,*,財産,ザイサン,ザイサン
税関	名詞,固有名詞,組織,*,*,*,税関,ゼイカン,ゼイカン
任務	名詞,一般,*,*,*,*,任務,ニンム,ニンム
国境警備隊	名詞,固有名詞,組織,*,*,*,国境警備隊,コッキョウケイビタイ,コッキョーケイビタイ
準	接頭詞,名詞接続,*,*,*,*,準,ジュン,ジュン
刑務	名詞,一般,*,*,*,*,刑務,ケイム,ケイム
司法省	名詞,固有名詞,組織,*,*,*,司法省,シホウショウ,シホーショー
刑務所	名詞,一般,*,*,*,*,刑務所,ケイムショ,ケイムショ
管理	名詞,サ変接続,*,*,*,*,管理,カンリ,カンリ
傘下	名詞,一般,*,*,*,*,傘下,サンカ,サンカ
整理	名詞,サ変接続,*,*,*,*,整理,セイリ,セイリ
捜索	名詞,サ変接続,*,*,*,*,捜索,ソウサク,ソーサク
救難	名詞,一般,*,*,*,*,救難,キュウナン,キューナン
漁業	名詞,一般,*,*,*,*,漁業,ギョギョウ,ギョギョー
監視	名詞,サ変接続,*,*,*,*,監視,カンシ,カンシ
示す	動詞,自立,*,*,五段・サ行,基本形,示す,シメス,シメス
多大	名詞,形容動詞語幹,*,*,*,*,多大,タダイ,タダイ
持っ	動詞,自立,*,*,五段・タ行,連用タ接続,持つ,モッ,モッ
元来	名詞,副詞可能,*,*,*,*,元来,ガンライ,ガンライ
後期	名詞,一般,*,*,*,*,後期,コウキ,コーキ
生まれ	動詞,自立,*,*,一段,連用形,生まれる,ウマレ,ウマレ
秘密	名詞,一般,*,*,*,*,秘密,ヒミツ,ヒミツ
結社	名詞,一般,*,*,*,*,結社,ケッシャ,ケッシャ
親族	名詞,一般,*,*,*,*,親族,シンゾク,シンゾク
冷酷	名詞,形容動詞語幹,*,*,*,*,冷酷,レイコク,レイコク
暴力	名詞,一般,*,*,*,*,暴力,ボウリョク,ボーリョク
オメルタ	名詞,一般,*,*,*,*,*
厳しい	形容詞,自立,*,*,形容詞・イ段,基本形,厳しい,キビシイ,キビシイ
掟	名詞,一般,*,*,*,*,掟,オキテ,オキテ
田園	名詞,一般,*,*,*,*,田園,デンエン,デンエン
当局	名詞,一般,*,*,*,*,当局,トウキョク,トーキョク
ゆすり	名詞,一般,*,*,*,*,ゆすり,ユスリ,ユスリ
戦	名詞,一般,*,*,*,*,戦,セン,セン
混じっ	動詞,自立,*,*,五段・ラ行,連用タ接続,混じる,マジッ,マジッ
北米	名詞,固有名詞,地域,一般,*,*,北米,ホクベイ,ホクベイ
渡っ	動詞,自立,*,*,五段・ラ行,連用タ接続,渡る,ワタッ,ワタッ
合法	名詞,一般,*,*,*,*,合法,ゴウホウ,ゴーホー
非合法	名詞,形容動詞語幹,*,*,*,*,非合法,ヒゴウホウ,ヒゴーホー
展開	名詞,サ変接続,*,*,*,*,展開,テンカイ,テンカイ
合衆国	名詞,一般,*,*,*,*,合衆国,ガッシュウコク,ガッシューコク
服役	名詞,サ変接続,*,*,*,*,服役,フクエキ,フクエキ
ラッキー・ルチアーノ	名詞,一般,*,*,*,*,*
ハス	名詞,一般,*,*,*,*,ハス,ハス,ハス
キー	名詞,一般,*,*,*,*,キー,キー,キー
ヘロイン	名詞,一般,*,*,*,*,ヘロイン,ヘロイン,ヘロイン
取り引き	名詞,サ変接続,*,*,*,*,取り引き,トリヒキ,トリヒキ
入っ	動詞,自立,*,*,五段・ラ行,連用タ接続,入る,ハイッ,ハイッ
書	名詞,接尾,一般,*,*,*,書,ショ,ショ
相当	名詞,サ変接続,*,*,*,*,相当,ソウトウ,ソートー
いう	動詞,自立,*,*,五段・ワ行促音便,基本形,いう,イウ,イウ
収益	名詞,一般,*,*,*,*,収益,シュウエキ,シューエキ
資金	名詞,一般,*,*,*,*,資金,シキン,シキン
洗浄	名詞,サ変接続,*,*,*,*,洗浄,センジョウ,センジョー
ハーグ	名詞,固有名詞,地域,一般,*,*,ハーグ,ハーグ,ハーグ
電気	名詞,一般,*,*,*,*,電気,デンキ,デンキ
通信	名詞,サ変接続,*,*,*,*,通信,ツウシン,ツーシン
インターネット	名詞,一般,*,*,*,*,インターネット,インターネット,インターネット
検閲	名詞,サ変接続,*,*,*,*,検閲,ケンエツ,ケンエツ
輩出	名詞,サ変接続,*,*,*,*,輩出,ハイシュツ,ハイシュツ
制作	名詞,サ変接続,*,*,*,*,制作,セイサク,セイサク
項	名詞,一般,*,*,*,*,項,コウ,コー
ジュゼッペ・ヴェルディ	名詞,一般,*,*,*,*,*
アイーダ	名詞,固有名詞,人名,一般,*,*,アイーダ,アイーダ,アイーダ
オペラ	名詞,一般,*,*,*,*,オペラ,オペラ,オペラ
民衆	名詞,一般,*,*,*,*,民衆,ミンシュウ,ミンシュー
カンツォーネ	名詞,一般,*,*,*,*,カンツォーネ,カンツォーネ,カンツォーネ
歌謡	名詞,一般,*,*,*,*,歌謡,カヨウ,カヨー
曲	名詞,接尾,一般,*,*,*,曲,キョク,キョク
バレエ	名詞,一般,*,*,*,*,バレエ,バレエ,バレー
ノーベル	名詞,固有名詞,人名,一般,*,*,ノーベル,ノーベル,ノーベル
賞	名詞,接尾,一般,*,*,*,賞,ショウ,ショー
作家	名詞,一般,*,*,*,*,作家,サッカ,サッカ
絶えず	副詞,一般,*,*,*,*,絶えず,タエズ,タエズ
送り出し	動詞,自立,*,*,五段・サ行,連用形,送り出す,オクリダシ,オクリダシ
時計	名詞,一般,*,*,*,*,時計,トケイ,トケイ
回り	名詞,一般,*,*,*,*,回り,マワリ,マワリ
マルゲリータ	名詞,固有名詞,人名,名,*,*,マルゲリータ,マルゲリータ,マルゲリータ
ピッツァ	名詞,一般,*,*,*,*,ピッツァ,ピッツァ,ピッツァ
ピッツア・マルゲリータ	名詞,一般,*,*,*,*,*
カルボナーラ	名詞,一般,*,*,*,*,*
スパゲッティ・カルボナーラ	名詞,一般,*,*,*,*,*
エスプレッソ	名詞,一般,*,*,*,*,エスプレッソ,エスプレッソ,エスプレッソ
ジェラート	名詞,一般,*,*,*,*,*
色	名詞,接尾,一般,*,*,*,色,ショク,ショク
強く	形容詞,自立,*,*,形容詞・アウオ段,連用テ接続,強い,ツヨク,ツヨク
バター	名詞,一般,*,*,*,*,バター,バター,バター
使い	動詞,自立,*,*,五段・ワ行促音便,連用形,使う,ツカイ,ツカイ
トマト	名詞,一般,*,*,*,*,トマト,トマト,トマト
多用	名詞,サ変接続,*,*,*,*,多用,タヨウ,タヨー
魚	名詞,接尾,一般,*,*,*,魚,ギョ,ギョ
食べる	動詞,自立,*,*,一段,基本形,食べる,タベル,タベル
内陸	名詞,一般,*,*,*,*,内陸,ナイリク,ナイリク
食べ	動詞,自立,*,*,一段,未然形,食べる,タベ,タベ
マグリブ	名詞,一般,*,*,*,*,*
食	名詞,一般,*,*,*,*,食,ショク,ショク
ハンガリー	名詞,固有名詞,地域,国,*,*,ハンガリー,ハンガリー,ハンガリー
パン	名詞,一般,*,*,*,*,パン,パン,パン
主食	名詞,一般,*,*,*,*,主食,シュショク,シュショク
流域	名詞,一般,*,*,*,*,流域,リュウイキ,リューイキ
よく	副詞,一般,*,*,*,*,よく,ヨク,ヨク
代用	名詞,サ変接続,*,*,*,*,代用,ダイヨウ,ダイヨー
トウモロコシ	名詞,一般,*,*,*,*,トウモロコシ,トウモロコシ,トーモロコシ
粉	名詞,一般,*,*,*,*,粉,コナ,コナ
ポレンタ	名詞,一般,*,*,*,*,*
ピザ	名詞,一般,*,*,*,*,ピザ,ピザ,ピザ
食事	名詞,サ変接続,*,*,*,*,食事,ショクジ,ショクジ
合わせる	動詞,自立,*,*,一段,基本形,合わせる,アワセル,アワセル
土地	名詞,一般,*,*,*,*,土地,トチ,トチ
飲む	動詞,自立,*,*,五段・マ行,基本形,飲む,ノム,ノム
サラミ	名詞,一般,*,*,*,*,サラミ,サラミ,サラミ
ハム	名詞,一般,*,*,*,*,ハム,ハム,ハム
食肉	名詞,一般,*,*,*,*,食肉,ショクニク,ショクニク
肉	名詞,一般,*,*,*,*,肉,ニク,ニク
特徴	名詞,一般,*,*,*,*,特徴,トクチョウ,トクチョー
コーヒー	名詞,一般,*,*,*,*,コーヒー,コーヒー,コーヒー
消費	名詞,サ変接続,*,*,*,*,消費,ショウヒ,ショーヒ
式	名詞,接尾,一般,*,*,*,式,シキ,シキ
いれ	動詞,自立,*,*,一段,連用形,いれる,イレ,イレ
方	名詞,接尾,特殊,*,*,*,方,カタ,カタ
カプチーノ	名詞,一般,*,*,*,*,カプチーノ,カプチーノ,カプチーノ
カフェ・ラッテ	名詞,一般,*,*,*,*,*
珍しく	形容詞,自立,*,*,形容詞・イ段,連用テ接続,珍しい,メズラシク,メズラシク
タコ	名詞,一般,*,*,*,*,タコ,タコ,タコ
ダンテ・アリギエーリ	名詞,一般,*,*,*,*,*
サンドロ・ボッティチェッリ	名詞,一般,*,*,*,*,*
作	名詞,接尾,一般,*,*,*,作,サク,サク
基礎	名詞,一般,*,*,*,*,基礎,キソ,キソ
詩人	名詞,一般,*,*,*,*,詩人,シジン,シジン
創設	名詞,サ変接続,*,*,*,*,創設,ソウセツ,ソーセツ
偉大	名詞,形容動詞語幹,*,*,*,*,偉大,イダイ,イダイ
神	名詞,接尾,一般,*,*,*,神,シン,シン
祝福	名詞,サ変接続,*,*,*,*,祝福,シュクフク,シュクフク
不足	名詞,サ変接続,*,*,*,*,不足,フソク,フソク
例	名詞,一般,*,*,*,*,例,レイ,レイ
挙げる	動詞,自立,*,*,一段,基本形,挙げる,アゲル,アゲル
なら	助動詞,*,*,*,特殊・ダ,仮定形,だ,ナラ,ナラ
ジョヴァンニ・ボッカチオ	名詞,一般,*,*,*,*,*
ジャコモ・レオパルディ	名詞,一般,*,*,*,*,*
アレッサンドロ・マンゾーニ	名詞,一般,*,*,*,*,*
トルクァート・タッソ	名詞,一般,*,*,*,*,*
ルドヴィーコ・アリオスト	名詞,一般,*,*,*,*,*
フランチェスコ・ペトラルカ	名詞,一般,*,*,*,*,*
人物	名詞,一般,*,*,*,*,人物,ジンブツ,ジンブツ
表現	名詞,サ変接続,*,*,*,*,表現,ヒョウゲン,ヒョーゲン
媒体	名詞,一般,*,*,*,*,媒体,バイタイ,バイタイ
生ん	動詞,自立,*,*,五段・マ行,連用タ接続,生む,ウン,ウン
ソネット	名詞,一般,*,*,*,*,ソネット,ソネット,ソネット
受賞	名詞,サ変接続,*,*,*,*,受賞,ジュショウ,ジュショー
ジョズエ・カルドゥッチ	名詞,一般,*,*,*,*,*
写実	名詞,一般,*,*,*,*,写実,シャジツ,シャジツ
グラツィア・デレッダ	名詞,一般,*,*,*,*,*
劇	名詞,一般,*,*,*,*,劇,ゲキ,ゲキ
ルイージ・ピランデッロ	名詞,一般,*,*,*,*,*
サルヴァトーレ・クァジモド	名詞,一般,*,*,*,*,*
エウジェーニオ・モンターレ	名詞,一般,*,*,*,*,*
風刺	名詞,サ変接続,*,*,*,*,風刺,フウシ,フーシ
ダリオ・フォ	名詞,一般,*,*,*,*,*
思想	名詞,一般,*,*,*,*,思想,シソウ,シソー
ジョルダーノ・ブルーノ	名詞,一般,*,*,*,*,*
マルシリオ・フィチーノ	名詞,一般,*,*,*,*,*
ニッコロ・マキャベリ	名詞,一般,*,*,*,*,*
ジャンバティスタ・ヴィコ	名詞,一般,*,*,*,*,*
傑出	名詞,サ変接続,*,*,*,*,傑出,ケッシュツ,ケッシュツ
ベネデット・クローチェ	名詞,一般,*,*,*,*,*
ジョヴァンニ・ジェンティーレ	名詞,一般,*,*,*,*,*
ヘーゲル	名詞,一般,*,*,*,*,*
観念論	名詞,一般,*,*,*,*,観念論,カンネンロン,カンネンロン
昇華	名詞,サ変接続,*,*,*,*,昇華,ショウカ,ショーカ
ジェンティーレ	名詞,一般,*,*,*,*,*
理論	名詞,一般,*,*,*,*,理論,リロン,リロン
支柱	名詞,一般,*,*,*,*,支柱,シチュウ,シチュー
特筆	名詞,サ変接続,*,*,*,*,特筆,トクヒツ,トクヒツ
マルクス主義	名詞,一般,*,*,*,*,マルクス主義,マルクスシュギ,マルクスシュギ
読み方	名詞,一般,*,*,*,*,読み方,ヨミカタ,ヨミカタ
サバルタン	名詞,一般,*,*,*,*,*
ヘゲモニー	名詞,一般,*,*,*,*,ヘゲモニー,ヘゲモニー,ヘゲモニー
概念	名詞,一般,*,*,*,*,概念,ガイネン,ガイネン
つながる	動詞,自立,*,*,五段・ラ行,基本形,つながる,ツナガル,ツナガル
アントニオ	名詞,固有名詞,人名,名,*,*,アントニオ,アントニオ,アントニオ
グラム	名詞,固有名詞,人名,姓,*,*,グラム,グラム,グラム
シ	名詞,一般,*,*,*,*,シ,シ,シ
読み直し	動詞,自立,*,*,五段・サ行,連用形,読み直す,ヨミナオシ,ヨミナオシ
ジョエーレ・ソラーリ	名詞,一般,*,*,*,*,*
マルチチュード	名詞,一般,*,*,*,*,*
学派	名詞,一般,*,*,*,*,学派,ガクハ,ガクハ
アントニオ・ネグリ	名詞,一般,*,*,*,*,*
ホモ・サケル	名詞,一般,*,*,*,*,*
ジョルジョ・アガンベン	名詞,一般,*,*,*,*,*
活躍	名詞,サ変接続,*,*,*,*,活躍,カツヤク,カツヤク
用い	動詞,自立,*,*,一段,未然形,用いる,モチイ,モチイ
用語	名詞,一般,*,*,*,*,用語,ヨウゴ,ヨーゴ
わかる	動詞,自立,*,*,五段・ラ行,基本形,わかる,ワカル,ワカル
バロック	名詞,一般,*,*,*,*,バロック,バロック,バロック
古典	名詞,一般,*,*,*,*,古典,コテン,コテン
ジョヴァンニ・ダ・パレストリーナ	名詞,一般,*,*,*,*,*
初期	名詞,一般,*,*,*,*,初期,ショキ,ショキ
クラウディオ・モンテヴェルディ	名詞,一般,*,*,*,*,*
中期	名詞,一般,*,*,*,*,中期,チュウキ,チューキ
アレッサンドロ・スカルラッティ	名詞,一般,*,*,*,*,*
アルカンジェロ・コレッリ	名詞,一般,*,*,*,*,*
アントニオ・ヴィヴァルディ	名詞,一般,*,*,*,*,*
視点	名詞,一般,*,*,*,*,視点,シテン,シテン
見れ	動詞,自立,*,*,一段,仮定形,見る,ミレ,ミレ
終盤	名詞,一般,*,*,*,*,終盤,シュウバン,シューバン
ウィーン	名詞,固有名詞,地域,一般,*,*,ウィーン,ウィーン,ウィーン
ヨハン・ゼバスティアン・バッハ	名詞,一般,*,*,*,*,*
復権	名詞,サ変接続,*,*,*,*,復権,フッケン,フッケン
オーストリ	名詞,一般,*,*,*,*,*
移っ	動詞,自立,*,*,五段・ラ行,連用タ接続,移る,ウツッ,ウツッ
作曲	名詞,サ変接続,*,*,*,*,作曲,サッキョク,サッキョク
ドメニコ・チマローザ	名詞,一般,*,*,*,*,*
ルイジ・ボッケリーニ	名詞,一般,*,*,*,*,*
演奏	名詞,サ変接続,*,*,*,*,演奏,エンソウ,エンソー
機会	名詞,一般,*,*,*,*,機会,キカイ,キカイ
比較的	副詞,一般,*,*,*,*,比較的,ヒカクテキ,ヒカクテキ
ロマン	名詞,一般,*,*,*,*,ロマン,ロマン,ロマン
人気	名詞,一般,*,*,*,*,人気,ニンキ,ニンキ
集め	動詞,自立,*,*,一段,連用形,集める,アツメ,アツメ
前期	名詞,一般,*,*,*,*,前期,ゼンキ,ゼンキ
ジョアッキーノ・ロッシーニ	名詞,一般,*,*,*,*,*
ヴィンチェンツォ・ベッリーニ	名詞,一般,*,*,*,*,*
ガエターノ・ドニゼッティ	名詞,一般,*,*,*,*,*
コモ	名詞,一般,*,*,*,*,コモ,コモ,コモ
プッチーニ	名詞,固有名詞,人名,姓,*,*,プッチーニ,プッチーニ,プッチーニ
保ち	動詞,自立,*,*,五段・タ行,連用形,保つ,タモチ,タモチ
続け	動詞,非自立,*,*,一段,連用形,続ける,ツヅケ,ツズケ
いえ	動詞,自立,*,*,五段・ワ行促音便,仮定形,いう,イエ,イエ
イメージ	名詞,サ変接続,*,*,*,*,イメージ,イメージ,イメージ
財政難	名詞,一般,*,*,*,*,財政難,ザイセイナン,ザイセイナン
カンパニー	名詞,一般,*,*,*,*,カンパニー,カンパニー,カンパニー
維持	名詞,サ変接続,*,*,*,*,維持,イジ,イジ
でき	動詞,自立,*,*,一段,未然形,できる,デキ,デキ
歌劇	名詞,一般,*,*,*,*,歌劇,カゲキ,カゲキ
場	名詞,接尾,一般,*,*,*,場,ジョウ,ジョー
上演	名詞,サ変接続,*,*,*,*,上演,ジョウエン,ジョーエン
倍	名詞,接尾,助数詞,*,*,*,倍,バイ,バイ
つけ	動詞,自立,*,*,一段,未然形,つける,ツケ,ツケ
すら	助詞,係助詞,*,*,*,*,すら,スラ,スラ
今世紀	名詞,一般,*,*,*,*,今世紀,コンセイキ,コンセイキ
管弦楽	名詞,一般,*,*,*,*,管弦楽,カンゲンガク,カンゲンガク
合唱	名詞,サ変接続,*,*,*,*,合唱,ガッショウ,ガッショー
全員	名詞,一般,*,*,*,*,全員,ゼンイン,ゼンイン
解雇	名詞,サ変接続,*,*,*,*,解雇,カイコ,カイコ
宣告	名詞,サ変接続,*,*,*,*,宣告,センコク,センコク
交響	名詞,一般,*,*,*,*,交響,コウキョウ,コーキョー
器楽	名詞,一般,*,*,*,*,器楽,キガク,キガク
オットリーノ・レスピーギ	名詞,一般,*,*,*,*,*
ジャン・フランチェスコ・マリピエロ	名詞,一般,*,*,*,*,*
魅力	名詞,一般,*,*,*,*,魅力,ミリョク,ミリョク
既に	副詞,一般,*,*,*,*,既に,スデニ,スデニ
なくなっ	動詞,自立,*,*,五段・ラ行,連用タ接続,なくなる,ナクナッ,ナクナッ
ルイジ・ノーノ	名詞,一般,*,*,*,*,*
ルチアーノ・ベリオ	名詞,一般,*,*,*,*,*
ジャン・ロレンツォ・ベルニーニ	名詞,一般,*,*,*,*,*
ベルニーニ	名詞,一般,*,*,*,*,*
聖	名詞,一般,*,*,*,*,聖,ヒジリ,ヒジリ
テレジア	名詞,一般,*,*,*,*,*
法悦	名詞,一般,*,*,*,*,法悦,ホウエツ,ホーエツ
マニエリスム	名詞,一般,*,*,*,*,*
自性	名詞,一般,*,*,*,*,自性,ジショウ,ジショー
消え	動詞,自立,*,*,一段,連用形,消える,キエ,キエ
色彩	名詞,一般,*,*,*,*,色彩,シキサイ,シキサイ
マッキア	名詞,一般,*,*,*,*,*
登場	名詞,サ変接続,*,*,*,*,登場,トウジョウ,トージョー
未来	名詞,一般,*,*,*,*,未来,ミライ,ミライ
好戦	名詞,一般,*,*,*,*,好戦,コウセン,コーセン
モード	名詞,一般,*,*,*,*,モード,モード,モード
形而上	名詞,一般,*,*,*,*,形而上,ケイジジョウ,ケイジジョー
抽象	名詞,サ変接続,*,*,*,*,抽象,チュウショウ,チューショー
画	名詞,接尾,一般,*,*,*,画,ガ,ガ
量産	名詞,サ変接続,*,*,*,*,量産,リョウサン,リョーサン
不安	名詞,形容動詞語幹,*,*,*,*,不安,フアン,フアン
象徴	名詞,サ変接続,*,*,*,*,象徴,ショウチョウ,ショーチョー
外圧	名詞,一般,*,*,*,*,外圧,ガイアツ,ガイアツ
原	名詞,固有名詞,人名,姓,*,*,原,ハラ,ハラ
かき消さ	動詞,自立,*,*,五段・サ行,未然形,かき消す,カキケサ,カキケサ
アルテ・ポーヴェラ	名詞,一般,*,*,*,*,*
トランス	名詞,一般,*,*,*,*,トランス,トランス,トランス
アバンギャルド	名詞,一般,*,*,*,*,アバンギャルド,アバンギャルド,アバンギャルド
フェデリコ・フェリーニ	名詞,一般,*,*,*,*,*
リュミエール	名詞,固有名詞,人名,姓,*,*,リュミエール,リュミエール,リュミエール
兄弟	名詞,一般,*,*,*,*,兄弟,キョウダイ,キョーダイ
始め	動詞,自立,*,*,一段,連用形,始める,ハジメ,ハジメ
わずか	副詞,助詞類接続,*,*,*,*,わずか,ワズカ,ワズカ
始まっ	動詞,自立,*,*,五段・ラ行,連用タ接続,始まる,ハジマッ,ハジマッ
レオ	名詞,固有名詞,組織,*,*,*,レオ,レオ,レオ
カメラ	名詞,一般,*,*,*,*,カメラ,カメラ,カメラ
秒間	名詞,接尾,助数詞,*,*,*,秒間,ビョウカン,ビョーカン
チネス	名詞,一般,*,*,*,*,*
アンブロシオ	名詞,一般,*,*,*,*,*
イタラ・フィルム	名詞,一般,*,*,*,*,*
すぐ	副詞,助詞類接続,*,*,*,*,すぐ,スグ,スグ
まもなく	副詞,助詞類接続,*,*,*,*,まもなく,マモナク,マモナク
公正	名詞,形容動詞語幹,*,*,*,*,公正,コウセイ,コーセイ
売ら	動詞,自立,*,*,五段・ラ行,未然形,売る,ウラ,ウラ
のち	名詞,副詞可能,*,*,*,*,のち,ノチ,ノチ
プロパガンダ	名詞,一般,*,*,*,*,プロパガンダ,プロパガンダ,プロパガンダ
広く	形容詞,自立,*,*,形容詞・アウオ段,連用テ接続,広い,ヒロク,ヒロク
頃	名詞,接尾,副詞可能,*,*,*,頃,ゴロ,ゴロ
凋落	名詞,サ変接続,*,*,*,*,凋落,チョウラク,チョーラク
監督	名詞,サ変接続,*,*,*,*,監督,カントク,カントク
ヴィットリオ・デ・シーカ	名詞,一般,*,*,*,*,*
セルジオ・レオーネ	名詞,一般,*,*,*,*,*
ルキノ・ヴィスコンティ	名詞,一般,*,*,*,*,*
ピエル・パオロ・パゾリーニ	名詞,一般,*,*,*,*,*
ミケランジェロ・アントニオーニ	名詞,一般,*,*,*,*,*
ダリオ・アルジェント	名詞,一般,*,*,*,*,*
ネオレアリスモ	名詞,一般,*,*,*,*,*
重厚	名詞,形容動詞語幹,*,*,*,*,重厚,ジュウコウ,ジューコー
出発	名詞,サ変接続,*,*,*,*,出発,シュッパツ,シュッパツ
次第に	副詞,一般,*,*,*,*,次第に,シダイニ,シダイニ
奔放	名詞,形容動詞語幹,*,*,*,*,奔放,ホンポウ,ホンポー
華麗	名詞,形容動詞語幹,*,*,*,*,華麗,カレイ,カレイ
前衛	名詞,一般,*,*,*,*,前衛,ゼンエイ,ゼンエイ
残酷	名詞,形容動詞語幹,*,*,*,*,残酷,ザンコク,ザンコク
味	名詞,接尾,一般,*,*,*,味,ミ,ミ
前面	名詞,一般,*,*,*,*,前面,ゼンメン,ゼンメン
出し	動詞,自立,*,*,五段・サ行,連用形,出す,ダシ,ダシ
マカロニウェスタン	名詞,一般,*,*,*,*,*
ホラー	名詞,一般,*,*,*,*,ホラー,ホラー,ホラー
娯楽	名詞,一般,*,*,*,*,娯楽,ゴラク,ゴラク
幅	名詞,一般,*,*,*,*,幅,ハバ,ハバ
驚く	動詞,自立,*,*,五段・カ行イ音便,基本形,驚く,オドロク,オドロク
広い	形容詞,自立,*,*,形容詞・アウオ段,基本形,広い,ヒロイ,ヒロイ
国柄	名詞,一般,*,*,*,*,国柄,クニガラ,クニガラ
生かし	動詞,自立,*,*,五段・サ行,連用形,生かす,イカシ,イカシ
紹介	名詞,サ変接続,*,*,*,*,紹介,ショウカイ,ショーカイ
喜劇	名詞,一般,*,*,*,*,喜劇,キゲキ,キゲキ
厚い	形容詞,自立,*,*,形容詞・アウオ段,基本形,厚い,アツイ,アツイ
残る	動詞,自立,*,*,五段・ラ行,基本形,残る,ノコル,ノコル
甘い	形容詞,自立,*,*,形容詞・アウオ段,基本形,甘い,アマイ,アマイ
続	接頭詞,名詞接続,*,*,*,*,続,ゾク,ゾク
夕陽	名詞,一般,*,*,*,*,夕陽,ユウヒ,ユーヒ
ガン	名詞,一般,*,*,*,*,ガン,ガン,ガン
泥棒	名詞,一般,*,*,*,*,泥棒,ドロボウ,ドロボー
バッハ	名詞,固有名詞,人名,一般,*,*,バッハ,バッハ,バッハ
協奏曲	名詞,一般,*,*,*,*,協奏曲,キョウソウキョク,キョーソーキョク
フェリックス・メンデルスゾーン	名詞,一般,*,*,*,*,*
メンデルスゾーン	名詞,固有名詞,人名,姓,*,*,メンデルスゾーン,メンデルスゾーン,メンデルスゾーン
番	名詞,接尾,助数詞,*,*,*,番,バン,バン
イ長調	名詞,一般,*,*,*,*,イ長調,イチョウチョウ,イチョーチョー
ピョートル・チャイコフスキー	名詞,一般,*,*,*,*,*
チャイコフスキー	名詞,固有名詞,人名,姓,*,*,チャイコフスキー,チャイコフスキー,チャイコフスキー
奇想	名詞,一般,*,*,*,*,奇想,キソウ,キソー
エクトル・ベルリオーズ	名詞,一般,*,*,*,*,*
ベルリオーズ	名詞,一般,*,*,*,*,*
ハロルド	名詞,一般,*,*,*,*,*
』	記号,括弧閉,*,*,*,*,』,』,』
レスピーギ	名詞,一般,*,*,*,*,*
詩	名詞,一般,*,*,*,*,詩,シ,シ
噴水	名詞,一般,*,*,*,*,噴水,フンスイ,フンスイ
松	名詞,一般,*,*,*,*,松,マツ,マツ
祭	名詞,一般,*,*,*,*,祭,マツリ,マツリ
ヨハン・ヴォルフガング・フォン・ゲーテ	名詞,一般,*,*,*,*,*
ゲーテ	名詞,固有名詞,人名,姓,*,*,ゲーテ,ゲーテ,ゲーテ
著	名詞,接尾,人名,*,*,*,著,チョ,チョ
紀行	名詞,一般,*,*,*,*,紀行,キコウ,キコー
ハンス	名詞,固有名詞,人名,名,*,*,ハンス,ハンス,ハンス
クリスチャン	名詞,一般,*,*,*,*,クリスチャン,クリスチャン,クリスチャン
アンデルセン	名詞,固有名詞,人名,姓,*,*,アンデルセン,アンデルセン,アンデルセン
即興	名詞,一般,*,*,*,*,即興,ソッキョウ,ソッキョー
白夜	名詞,一般,*,*,*,*,白夜,ビャクヤ,ビャクヤ
昨日	名詞,副詞可能,*,*,*,*,昨日,キノウ,キノー
明日	名詞,副詞可能,*,*,*,*,明日,アシタ,アシタ
宮崎	名詞,固有名詞,人名,姓,*,*,宮崎,ミヤザキ,ミヤザキ
駿	名詞,固有名詞,人名,名,*,*,駿,シュン,シュン
紅	名詞,一般,*,*,*,*,紅,ベニ,ベニ
豚	名詞,一般,*,*,*,*,豚,ブタ,ブタ
オードリー	名詞,固有名詞,人名,一般,*,*,オードリー,オードリー,オードリー
ウェルズ	名詞,固有名詞,人名,姓,*,*,ウェルズ,ウェルズ,ウェルズ
休日	名詞,副詞可能,*,*,*,*,休日,キュウジツ,キュージツ
漫画	名詞,一般,*,*,*,*,漫画,マンガ,マンガ
天野	名詞,固有名詞,人名,姓,*,*,天野,アマノ,アマノ
こずえ	名詞,固有名詞,人名,名,*,*,こずえ,コズエ,コズエ
アクア	名詞,一般,*,*,*,*,*
荒木	名詞,一般,*,*,*,*,荒木,アラキ,アラキ
飛	名詞,一般,*,*,*,*,飛,ヒ,ヒ
呂	名詞,一般,*,*,*,*,呂,リョ,リョ
彦	名詞,一般,*,*,*,*,*
ジョジョ	名詞,一般,*,*,*,*,*
奇妙	名詞,形容動詞語幹,*,*,*,*,奇妙,キミョウ,キミョー
冒険	名詞,サ変接続,*,*,*,*,冒険,ボウケン,ボーケン
黄金	名詞,一般,*,*,*,*,黄金,オウゴン,オーゴン
風	名詞,一般,*,*,*,*,風,カゼ,カゼ
相田	名詞,固有名詞,人名,姓,*,*,相田,アイダ,アイダ
明	名詞,固有名詞,人名,名,*,*,明,アキラ,アキラ
家庭	名詞,一般,*,*,*,*,家庭,カテイ,カテイ
教師	名詞,一般,*,*,*,*,教師,キョウシ,キョーシ
ヒット	名詞,サ変接続,*,*,*,*,ヒット,ヒット,ヒット
大河原	名詞,固有名詞,組織,*,*,*,大河原,オオガワラ,オーガワラ
遁	名詞,一般,*,*,*,*,*
王様	名詞,一般,*,*,*,*,王様,オウサマ,オーサマ
仕立て屋	名詞,一般,*,*,*,*,仕立て屋,シタテヤ,シタテヤ
～	記号,一般,*,*,*,*,～,～,～
サルト・フィニート	名詞,一般,*,*,*,*,*
幅広い	形容詞,自立,*,*,形容詞・アウオ段,基本形,幅広い,ハバヒロイ,ハバヒロイ
様式	名詞,一般,*,*,*,*,様式,ヨウシキ,ヨーシキ
起源	名詞,一般,*,*,*,*,起源,キゲン,キゲン
遡る	動詞,自立,*,*,五段・ラ行,基本形,遡る,サカノボル,サカノボル
出来る	動詞,自立,*,*,一段,基本形,出来る,デキル,デキル
小国	名詞,一般,*,*,*,*,小国,ショウコク,ショーコク
様々	名詞,形容動詞語幹,*,*,*,*,様々,サマザマ,サマザマ
簡単	名詞,形容動詞語幹,*,*,*,*,簡単,カンタン,カンタン
出来	動詞,自立,*,*,一段,未然形,出来る,デキ,デキ
カテゴリー	名詞,一般,*,*,*,*,カテゴリー,カテゴリー,カテゴリー
時	名詞,非自立,副詞可能,*,*,*,時,トキ,トキ
系列	名詞,一般,*,*,*,*,系列,ケイレツ,ケイレツ
ユネスコ	名詞,固有名詞,組織,*,*,*,ユネスコ,ユネスコ,ユネスコ
自然	名詞,形容動詞語幹,*,*,*,*,自然,シゼン,シゼン
日付	名詞,一般,*,*,*,*,日付,ヒヅケ,ヒズケ
元日	名詞,固有名詞,一般,*,*,*,元日,ガンジツ,ガンジツ
エピファニー	名詞,一般,*,*,*,*,*
公	名詞,一般,*,*,*,*,公,オオヤケ,オーヤケ
祭日	名詞,一般,*,*,*,*,祭日,サイジツ,サイジツ
復活	名詞,サ変接続,*,*,*,*,復活,フッカツ,フッカツ
祭	名詞,接尾,一般,*,*,*,祭,サイ,サイ
月曜	名詞,副詞可能,*,*,*,*,月曜,ゲツヨウ,ゲツヨー
解放	名詞,サ変接続,*,*,*,*,解放,カイホウ,カイホー
記念	名詞,サ変接続,*,*,*,*,記念,キネン,キネン
日	名詞,接尾,一般,*,*,*,日,ビ,ビ
聖母	名詞,一般,*,*,*,*,聖母,セイボ,セイボ
被	接頭詞,名詞接続,*,*,*,*,被,ヒ,ヒ
昇天	名詞,サ変接続,*,*,*,*,昇天,ショウテン,ショーテン
諸	接頭詞,名詞接続,*,*,*,*,諸,ショ,ショ
聖人	名詞,一般,*,*,*,*,聖人,セイジン,セイジン
日	名詞,非自立,副詞可能,*,*,*,日,ヒ,ヒ
原罪	名詞,一般,*,*,*,*,原罪,ゲンザイ,ゲンザイ
御	接頭詞,名詞接続,*,*,*,*,御,ゴ,ゴ
宿り	名詞,一般,*,*,*,*,宿り,ヤドリ,ヤドリ
クリスマス	名詞,一般,*,*,*,*,クリスマス,クリスマス,クリスマス
ステファノ	名詞,一般,*,*,*,*,*
祝日	名詞,一般,*,*,*,*,祝日,シュクジツ,シュクジツ
カルチョ	名詞,一般,*,*,*,*,*
フォーミュラ	名詞,一般,*,*,*,*,フォーミュラ,フォーミュラ,フォーミュラ
ミッレミリア	名詞,一般,*,*,*,*,*
マリン	名詞,固有名詞,一般,*,*,*,マリン,マリン,マリン
セリエ	名詞,一般,*,*,*,*,*
バレーボール	名詞,一般,*,*,*,*,バレーボール,バレーボール,バレーボール
コルティーナ・ダンペッツォ	名詞,一般,*,*,*,*,*
スキー	名詞,一般,*,*,*,*,スキー,スキー,スキー
リゾート	名詞,一般,*,*,*,*,リゾート,リゾート,リゾート
ウィンタースポーツ	名詞,一般,*,*,*,*,*
シックス・ネイションズ	名詞,一般,*,*,*,*,*
加わっ	動詞,自立,*,*,五段・ラ行,連用タ接続,加わる,クワワッ,クワワッ
比べる	動詞,自立,*,*,一段,基本形,比べる,クラベル,クラベル
スタディオ・ジュゼッペ・メアッツァ	名詞,一般,*,*,*,*,*
カルチョ・フィオレンティノ	名詞,一般,*,*,*,*,*
フットボール	名詞,一般,*,*,*,*,フットボール,フットボール,フットボール
双璧	名詞,一般,*,*,*,*,双璧,ソウヘキ,ソーヘキ
プレイヤー	名詞,一般,*,*,*,*,プレイヤー,プレイヤー,プレイヤー
強豪	名詞,一般,*,*,*,*,強豪,キョウゴウ,キョーゴー
ワールドカップ	名詞,固有名詞,一般,*,*,*,ワールドカップ,ワールドカップ,ワールドカップ
回	名詞,接尾,助数詞,*,*,*,回,カイ,カイ
度	名詞,接尾,助数詞,*,*,*,度,ド,ド
優勝	名詞,サ変接続,*,*,*,*,優勝,ユウショウ,ユーショー
輝い	動詞,自立,*,*,五段・カ行イ音便,連用タ接続,輝く,カガヤイ,カガヤイ
選手権	名詞,一般,*,*,*,*,選手権,センシュケン,センシュケン
ユニフォーム	名詞,一般,*,*,*,*,ユニフォーム,ユニフォーム,ユニフォーム
青い	形容詞,自立,*,*,形容詞・アウオ段,基本形,青い,アオイ,アオイ
色	名詞,一般,*,*,*,*,色,イロ,イロ
アズーリ	名詞,一般,*,*,*,*,*
鍵	名詞,一般,*,*,*,*,鍵,カギ,カギ
かける	動詞,自立,*,*,一段,基本形,かける,カケル,カケル
意味	名詞,サ変接続,*,*,*,*,意味,イミ,イミ
カテナチオ	名詞,一般,*,*,*,*,*
鉄壁	名詞,一般,*,*,*,*,鉄壁,テッペキ,テッペキ
守備	名詞,サ変接続,*,*,*,*,守備,シュビ,シュビ
ベース	名詞,一般,*,*,*,*,ベース,ベース,ベース
至る	動詞,自立,*,*,五段・ラ行,基本形,至る,イタル,イタル
攻撃	名詞,サ変接続,*,*,*,*,攻撃,コウゲキ,コーゲキ
陣	名詞,接尾,一般,*,*,*,陣,ジン,ジン
タレント	名詞,一般,*,*,*,*,タレント,タレント,タレント
チーム	名詞,一般,*,*,*,*,チーム,チーム,チーム
堅い	形容詞,自立,*,*,形容詞・アウオ段,基本形,堅い,カタイ,カタイ
素早い	形容詞,自立,*,*,形容詞・アウオ段,基本形,素早い,スバヤイ,スバヤイ
綿密	名詞,形容動詞語幹,*,*,*,*,綿密,メンミツ,メンミツ
戦術	名詞,一般,*,*,*,*,戦術,センジュツ,センジュツ
重んじる	動詞,自立,*,*,一段,基本形,重んじる,オモンジル,オモンジル
アリゴ・サッキ	名詞,一般,*,*,*,*,*
ジョバンニ・トラパットーニ	名詞,一般,*,*,*,*,*
名将	名詞,一般,*,*,*,*,名将,メイショウ,メイショー
フォーメーション	名詞,一般,*,*,*,*,*
考案	名詞,サ変接続,*,*,*,*,考案,コウアン,コーアン
チャンピオンズ	名詞,一般,*,*,*,*,チャンピオンズ,チャンピオンズ,チャンピオンズ
ミラン	名詞,一般,*,*,*,*,*
インテルナツィオナーレ・ミラノ	名詞,一般,*,*,*,*,*
インテル	名詞,固有名詞,組織,*,*,*,インテル,インテル,インテル
ユヴェントス	名詞,一般,*,*,*,*,*
果たし	動詞,自立,*,*,五段・サ行,連用形,果たす,ハタシ,ハタシ
コッパ・イタリア	名詞,一般,*,*,*,*,*
カップ	名詞,一般,*,*,*,*,カップ,カップ,カップ
戦	名詞,接尾,一般,*,*,*,戦,セン,セン
在籍	名詞,サ変接続,*,*,*,*,在籍,ザイセキ,ザイセキ
事	名詞,非自立,一般,*,*,*,事,コト,コト
中田	名詞,固有名詞,人名,姓,*,*,中田,ナカタ,ナカタ
英寿	名詞,固有名詞,人名,名,*,*,英寿,ヒデトシ,ヒデトシ
長友	名詞,固有名詞,人名,姓,*,*,長友,ナガトモ,ナガトモ
佑	名詞,固有名詞,人名,名,*,*,佑,タスク,タスク
都	名詞,接尾,地域,*,*,*,都,ト,ト
本田	名詞,固有名詞,人名,姓,*,*,本田,ホンダ,ホンダ
圭	名詞,固有名詞,人名,名,*,*,圭,ケイ,ケイ
ミラノダービー	名詞,一般,*,*,*,*,*
ダービー	名詞,一般,*,*,*,*,ダービー,ダービー,ダービー
屈指	名詞,一般,*,*,*,*,屈指,クッシ,クッシ
プロバスケットボールリーグ	名詞,一般,*,*,*,*,*
史上	名詞,一般,*,*,*,*,史上,シジョウ,シジョー
目	名詞,接尾,一般,*,*,*,目,メ,メ
初	名詞,接尾,一般,*,*,*,初,ハツ,ハツ
ドラフト	名詞,一般,*,*,*,*,ドラフト,ドラフト,ドラフト
アンドレア・バルニャーニ	名詞,一般,*,*,*,*,*
オリンピック	名詞,一般,*,*,*,*,オリンピック,オリンピック,オリンピック
アテネ	名詞,固有名詞,地域,一般,*,*,アテネ,アテネ,アテネ
女子	名詞,一般,*,*,*,*,女子,ジョシ,ジョシ
銅メダル	名詞,一般,*,*,*,*,銅メダル,ドウメダル,ドーメダル
上回る	動詞,自立,*,*,五段・ラ行,基本形,上回る,ウワマワル,ウワマワル
銀メダル	名詞,一般,*,*,*,*,銀メダル,ギンメダル,ギンメダル
バスケット	名詞,一般,*,*,*,*,バスケット,バスケット,バスケット
男子	名詞,一般,*,*,*,*,男子,ダンシ,ダンシ
金メダル	名詞,一般,*,*,*,*,金メダル,キンメダル,キンメダル
続々	副詞,助詞類接続,*,*,*,*,続々,ゾクゾク,ゾクゾク
と	助詞,副詞化,*,*,*,*,と,ト,ト
躍進	名詞,サ変接続,*,*,*,*,躍進,ヤクシン,ヤクシン
期待	名詞,サ変接続,*,*,*,*,期待,キタイ,キタイ
ニックネーム	名詞,一般,*,*,*,*,ニックネーム,ニックネーム,ニックネーム
ドライバー	名詞,一般,*,*,*,*,ドライバー,ドライバー,ドライバー
マシン	名詞,一般,*,*,*,*,マシン,マシン,マシン
バイク	名詞,一般,*,*,*,*,バイク,バイク,バイク
メーカー	名詞,一般,*,*,*,*,メーカー,メーカー,メーカー
創成	名詞,サ変接続,*,*,*,*,創成,ソウセイ,ソーセイ
トラクター	名詞,一般,*,*,*,*,トラクター,トラクター,トラクター
レーシングドライバー	名詞,一般,*,*,*,*,レーシングドライバー,レーシングドライバー,レーシングドライバー
アルパインスターズ	名詞,一般,*,*,*,*,*
マセラティ	名詞,一般,*,*,*,*,*
開幕	名詞,サ変接続,*,*,*,*,開幕,カイマク,カイマク
年	名詞,接尾,一般,*,*,*,年,ネン,ネン
スクーデリア・フェラーリ	名詞,一般,*,*,*,*,*
創業	名詞,サ変接続,*,*,*,*,創業,ソウギョウ,ソーギョー
エンツォ・フェラーリ	名詞,一般,*,*,*,*,*
近郊	名詞,一般,*,*,*,*,近郊,キンコウ,キンコー
マラネッロ	名詞,一般,*,*,*,*,*
構え	動詞,自立,*,*,一段,連用形,構える,カマエ,カマエ
異名	名詞,一般,*,*,*,*,異名,イミョウ,イミョー
とっ	動詞,自立,*,*,五段・ラ行,連用タ接続,とる,トッ,トッ
アルファロメオ・マセラティ	名詞,一般,*,*,*,*,*
撤退	名詞,サ変接続,*,*,*,*,撤退,テッタイ,テッタイ
残り	動詞,自立,*,*,五段・ラ行,連用形,残る,ノコリ,ノコリ
馳せ	動詞,自立,*,*,一段,連用形,馳せる,ハセ,ハセ
ミハエル	名詞,固有名詞,人名,名,*,*,ミハエル,ミハエル,ミハエル
シューマッハ	名詞,固有名詞,人名,姓,*,*,シューマッハ,シューマッハ,シューマッハ
ワールド	名詞,一般,*,*,*,*,ワールド,ワールド,ワールド
チャンピオン	名詞,一般,*,*,*,*,チャンピオン,チャンピオン,チャンピオン
ザウバー	名詞,一般,*,*,*,*,*
買収	名詞,サ変接続,*,*,*,*,買収,バイシュウ,バイシュー
アルファタウリ	名詞,一般,*,*,*,*,*
トロ・ロッソ	名詞,一般,*,*,*,*,*
ミナルディ	名詞,一般,*,*,*,*,*
非	接頭詞,名詞接続,*,*,*,*,非,ヒ,ヒ
珍しい	形容詞,自立,*,*,形容詞・イ段,基本形,珍しい,メズラシイ,メズラシイ
レーシングコンストラクター	名詞,一般,*,*,*,*,*
ダラーラ	名詞,一般,*,*,*,*,*
インディカー	名詞,一般,*,*,*,*,*
含む	動詞,自立,*,*,五段・マ行,基本形,含む,フクム,フクム
ワンメイクフォーミュラ	名詞,一般,*,*,*,*,*
シャシー	名詞,一般,*,*,*,*,シャシー,シャシー,シャシー
供給	名詞,サ変接続,*,*,*,*,供給,キョウキュウ,キョーキュー
独占	名詞,サ変接続,*,*,*,*,独占,ドクセン,ドクセン
ランチア	名詞,一般,*,*,*,*,*
実働	名詞,サ変接続,*,*,*,*,実働,ジツドウ,ジツドー
アバルト	名詞,一般,*,*,*,*,*
ラリー	名詞,一般,*,*,*,*,ラリー,ラリー,ラリー
デルタ・インテグラーレ	名詞,一般,*,*,*,*,*
名車	名詞,一般,*,*,*,*,名車,メイシャ,メイシャ
世	名詞,一般,*,*,*,*,世,ヨ,ヨ
破ら	動詞,自立,*,*,五段・ラ行,未然形,破る,ヤブラ,ヤブラ
マニュファクチャラーズ	名詞,一般,*,*,*,*,*
連覇	名詞,サ変接続,*,*,*,*,連覇,レンパ,レンパ
偉業	名詞,一般,*,*,*,*,偉業,イギョウ,イギョー
なしとげ	動詞,自立,*,*,一段,連用形,なしとげる,ナシトゲ,ナシトゲ
規定	名詞,サ変接続,*,*,*,*,規定,キテイ,キテイ
プライベーター	名詞,一般,*,*,*,*,*
細々	副詞,助詞類接続,*,*,*,*,細々,コマゴマ,コマゴマ
留まっ	動詞,自立,*,*,五段・ラ行,連用タ接続,留まる,トマッ,トマッ
スポーツカー	名詞,一般,*,*,*,*,スポーツカー,スポーツカー,スポーツカー
レース	名詞,一般,*,*,*,*,レース,レース,レース
ル・マン	名詞,固有名詞,地域,一般,*,*,ル・マン,ルマン,ルマン
時間	名詞,接尾,助数詞,*,*,*,時間,ジカン,ジカン
プライベーター	名詞,固有名詞,一般,*,*,*,*
ワークス	名詞,一般,*,*,*,*,ワークス,ワークス,ワークス
ハイ	名詞,一般,*,*,*,*,ハイ,ハイ,ハイ
パーカー	名詞,一般,*,*,*,*,パーカー,パーカー,パーカー
スクーデリア・キャメロン・グリッケンハウス	名詞,一般,*,*,*,*,*
主体	名詞,一般,*,*,*,*,主体,シュタイ,シュタイ
製作	名詞,サ変接続,*,*,*,*,製作,セイサク,セイサク
オペレーション	名詞,サ変接続,*,*,*,*,オペレーション,オペレーション,オペレーション
入り	名詞,接尾,サ変接続,*,*,*,入り,イリ,イリ
小林	名詞,固有名詞,人名,姓,*,*,小林,コバヤシ,コバヤシ
可	接頭詞,名詞接続,*,*,*,*,可,カ,カ
夢	名詞,一般,*,*,*,*,夢,ユメ,ユメ
偉	形容詞,自立,*,*,形容詞・アウオ段,ガル接続,偉い,エラ,エラ
ロードレース	名詞,一般,*,*,*,*,ロードレース,ロードレース,ロードレース
ドゥカティ	名詞,一般,*,*,*,*,*
アプリリア	名詞,固有名詞,組織,*,*,*,アプリリア,アプリリア,アプリリア
アグスタ	名詞,固有名詞,一般,*,*,*,アグスタ,アグスタ,アグスタ
黎明	名詞,一般,*,*,*,*,黎明,レイメイ,レイメイ
旧称	名詞,一般,*,*,*,*,旧称,キュウショウ,キューショー
空前絶後	名詞,一般,*,*,*,*,空前絶後,クウゼンゼツゴ,クーゼンゼツゴ
ライダースタイトル	名詞,一般,*,*,*,*,*
それでも	接続詞,*,*,*,*,*,それでも,ソレデモ,ソレデモ
コンストラクターズタイトル	名詞,一般,*,*,*,*,*
ヤマハ	名詞,固有名詞,組織,*,*,*,ヤマハ,ヤマハ,ヤマハ
ツイン	名詞,一般,*,*,*,*,ツイン,ツイン,ツイン
気筒	名詞,一般,*,*,*,*,気筒,キトウ,キトー
エンジン	名詞,一般,*,*,*,*,エンジン,エンジン,エンジン
規則	名詞,一般,*,*,*,*,規則,キソク,キソク
優遇	名詞,サ変接続,*,*,*,*,優遇,ユウグウ,ユーグー
見直さ	動詞,自立,*,*,五段・サ行,未然形,見直す,ミナオサ,ミナオサ
頭角	名詞,一般,*,*,*,*,頭角,トウカク,トーカク
表し	動詞,自立,*,*,五段・サ行,連用形,表す,アラワシ,アラワシ
徐々に	副詞,一般,*,*,*,*,徐々に,ジョジョニ,ジョジョニ
タイトル	名詞,一般,*,*,*,*,タイトル,タイトル,タイトル
遠ざかっ	動詞,自立,*,*,五段・ラ行,連用タ接続,遠ざかる,トオザカッ,トーザカッ
ライダー	名詞,一般,*,*,*,*,ライダー,ライダー,ライダー
ジャコモ・アゴスチーニ	名詞,一般,*,*,*,*,*
クラス	名詞,一般,*,*,*,*,クラス,クラス,クラス
同時	名詞,一般,*,*,*,*,同時,ドウジ,ドージ
改称	名詞,サ変接続,*,*,*,*,改称,カイショウ,カイショー
バレンティーノ・ロッシ	名詞,一般,*,*,*,*,*
連続	名詞,サ変接続,*,*,*,*,連続,レンゾク,レンゾク
フランコ・ウンチーニ	名詞,一般,*,*,*,*,*
マルコ・ルッキネリ	名詞,一般,*,*,*,*,*
リベロ・リベラッティ	名詞,一般,*,*,*,*,*
ウンベルト・マセッティ	名詞,一般,*,*,*,*,*
王者	名詞,一般,*,*,*,*,王者,オウジャ,オージャ
グランツール	名詞,一般,*,*,*,*,*
ジロ・デ・イタリア	名詞,一般,*,*,*,*,*
モニュメント	名詞,一般,*,*,*,*,モニュメント,モニュメント,モニュメント
モニュメンツ	名詞,一般,*,*,*,*,*
〜	名詞,サ変接続,*,*,*,*,*
サンレモ	名詞,固有名詞,地域,一般,*,*,サンレモ,サンレモ,サンレモ
イル・ロンバルディア	名詞,一般,*,*,*,*,*
開催	名詞,サ変接続,*,*,*,*,開催,カイサイ,カイサイ
アルフレッド・ビンダ	名詞,一般,*,*,*,*,*
ジーノ・バルタリ	名詞,一般,*,*,*,*,*
ファウスト・コッピ	名詞,一般,*,*,*,*,*
マルコ・パンターニ	名詞,一般,*,*,*,*,*
ジルベルト・シモーニ	名詞,一般,*,*,*,*,*
イヴァン・バッソ	名詞,一般,*,*,*,*,*
ヴィンチェンツォ・ニバリ	名詞,一般,*,*,*,*,*
スプリンター	名詞,一般,*,*,*,*,スプリンター,スプリンター,スプリンター
マリオ・チポッリーニ	名詞,一般,*,*,*,*,*
アレッサンドロ・ペタッキ	名詞,一般,*,*,*,*,*
エリア・ヴィヴィアーニ	名詞,一般,*,*,*,*,*
ジャコモ・ニッツォーロ	名詞,一般,*,*,*,*,*
次々	副詞,助詞類接続,*,*,*,*,次々,ツギツギ,ツギツギ
アペニノ	名詞,一般,*,*,*,*,*
メッカ	名詞,一般,*,*,*,*,メッカ,メッカ,メッカ
大会	名詞,一般,*,*,*,*,大会,タイカイ,タイカイ
渡り	動詞,自立,*,*,五段・ラ行,連用形,渡る,ワタリ,ワタリ
ライバル	名詞,一般,*,*,*,*,ライバル,ライバル,ライバル
君臨	名詞,サ変接続,*,*,*,*,君臨,クンリン,クンリン
五輪	名詞,一般,*,*,*,*,五輪,ゴリン,ゴリン
ベースボール	名詞,一般,*,*,*,*,ベースボール,ベースボール,ベースボール
リーガー	名詞,一般,*,*,*,*,リーガー,リーガー,リーガー
イタリアンベースボールリーグ	名詞,一般,*,*,*,*,*
杯	名詞,接尾,一般,*,*,*,杯,ハイ,ハイ
ベスト	名詞,一般,*,*,*,*,ベスト,ベスト,ベスト
破る	動詞,自立,*,*,五段・ラ行,基本形,破る,ヤブル,ヤブル
無敗	名詞,一般,*,*,*,*,無敗,ムハイ,ムハイ
ラウンド	名詞,一般,*,*,*,*,ラウンド,ラウンド,ラウンド
メキシコ	名詞,固有名詞,地域,国,*,*,メキシコ,メキシコ,メキシコ
勝利	名詞,サ変接続,*,*,*,*,勝利,ショウリ,ショーリ
初	名詞,一般,*,*,*,*,初,ハツ,ハツ
コールド	名詞,一般,*,*,*,*,コールド,コールド,コールド
収め	動詞,自立,*,*,一段,連用形,収める,オサメ,オサメ
ドミニカ共和国	名詞,固有名詞,地域,国,*,*,ドミニカ共和国,ドミニカキョウワコク,ドミニカキョーワコク
プエルトリコ	名詞,固有名詞,地域,国,*,*,プエルトリコ,プエルトリコ,プエルトリコ
連敗	名詞,サ変接続,*,*,*,*,連敗,レンパイ,レンパイ
喫し	動詞,自立,*,*,五段・サ行,連用形,喫す,キッシ,キッシ
敗退	名詞,サ変接続,*,*,*,*,敗退,ハイタイ,ハイタイ
賞金	名詞,一般,*,*,*,*,賞金,ショウキン,ショーキン
不払い	名詞,一般,*,*,*,*,不払い,フバライ,フバライ
陥っ	動詞,自立,*,*,五段・ラ行,連用タ接続,陥る,オチイッ,オチイッ
サラブレッド	名詞,一般,*,*,*,*,サラブレッド,サラブレッド,サラブレッド
頭数	名詞,一般,*,*,*,*,頭数,トウスウ,トースー
落ち込ん	動詞,自立,*,*,五段・マ行,連用タ接続,落ち込む,オチコン,オチコン
大賞	名詞,一般,*,*,*,*,大賞,タイショウ,タイショー
典	名詞,一般,*,*,*,*,典,テン,テン
競走	名詞,サ変接続,*,*,*,*,競走,キョウソウ,キョーソー
格付け	名詞,サ変接続,*,*,*,*,格付け,カクヅケ,カクズケ
平地	名詞,一般,*,*,*,*,平地,ヒラチ,ヒラチ
繋駕	名詞,一般,*,*,*,*,繋駕,ケイガ,ケイガ
速歩	名詞,一般,*,*,*,*,速歩,ハヤアシ,ハヤアシ
悪く	形容詞,自立,*,*,形容詞・アウオ段,連用テ接続,悪い,ワルク,ワルク
スタンダードブレッド	名詞,一般,*,*,*,*,*
半減	名詞,サ変接続,*,*,*,*,半減,ハンゲン,ハンゲン
似つかわしく	形容詞,自立,*,*,形容詞・イ段,連用テ接続,似つかわしい,ニツカワシク,ニツカワシク
強力	名詞,形容動詞語幹,*,*,*,*,強力,キョウリョク,キョーリョク
馬	名詞,接尾,一般,*,*,*,馬,バ,バ
最強	名詞,一般,*,*,*,*,最強,サイキョウ,サイキョー
候補	名詞,一般,*,*,*,*,候補,コウホ,コーホ
リボー	名詞,一般,*,*,*,*,*
ヴァレンヌ	名詞,一般,*,*,*,*,*
頭	名詞,接尾,助数詞,*,*,*,頭,トウ,トー
記憶	名詞,サ変接続,*,*,*,*,記憶,キオク,キオク
戦	名詞,接尾,助数詞,*,*,*,戦,セン,セン
不敗	名詞,一般,*,*,*,*,不敗,フハイ,フハイ
ネアルコ	名詞,一般,*,*,*,*,*
繁栄	名詞,サ変接続,*,*,*,*,繁栄,ハンエイ,ハンエイ
血	名詞,一般,*,*,*,*,血,チ,チ
持た	動詞,自立,*,*,五段・タ行,未然形,持つ,モタ,モタ
い	動詞,自立,*,*,一段,未然形,いる,イ,イ
デジタル	名詞,一般,*,*,*,*,デジタル,デジタル,デジタル
オブジェクト	名詞,一般,*,*,*,*,オブジェクト,オブジェクト,オブジェクト
パンフィロ・ジェンティーレ	名詞,一般,*,*,*,*,*
野上	名詞,固有名詞,人名,姓,*,*,野上,ノガミ,ノガミ
素一	名詞,固有名詞,人名,名,*,*,素一,ソイチ,ソイチ
訳	名詞,接尾,一般,*,*,*,訳,ヤク,ヤク
北原	名詞,固有名詞,人名,姓,*,*,北原,キタハラ,キタハラ
敦	名詞,固有名詞,人名,名,*,*,敦,アツシ,アツシ
山川	名詞,固有名詞,人名,姓,*,*,山川,ヤマカワ,ヤマカワ
出版	名詞,サ変接続,*,*,*,*,出版,シュッパン,シュッパン
読者	名詞,一般,*,*,*,*,読者,ドクシャ,ドクシャ
欄	名詞,一般,*,*,*,*,欄,ラン,ラン
操作	名詞,サ変接続,*,*,*,*,操作,ソウサ,ソーサ
法	名詞,接尾,一般,*,*,*,法,ホウ,ホー
使い方	名詞,一般,*,*,*,*,使い方,ツカイカタ,ツカイカタ
二つ	名詞,一般,*,*,*,*,二つ,フタツ,フタツ
分権	名詞,一般,*,*,*,*,分権,ブンケン,ブンケン
過ぎ	動詞,自立,*,*,一段,未然形,過ぎる,スギ,スギ
在日	名詞,サ変接続,*,*,*,*,在日,ザイニチ,ザイニチ
大使館	名詞,一般,*,*,*,*,大使館,タイシカン,タイシカン
全権	名詞,一般,*,*,*,*,全権,ゼンケン,ゼンケン
柴田	名詞,固有名詞,人名,姓,*,*,柴田,シバタ,シバタ
朝比奈	名詞,固有名詞,人名,姓,*,*,朝比奈,アサヒナ,アサヒナ
昌広	名詞,固有名詞,人名,名,*,*,昌広,マサヒロ,マサヒロ
牛込	名詞,固有名詞,人名,姓,*,*,牛込,ウシゴメ,ウシゴメ
重	名詞,固有名詞,人名,名,*,*,重,シゲル,シゲル
忝	名詞,一般,*,*,*,*,*
軍人	名詞,一般,*,*,*,*,軍人,グンジン,グンジン
ヴィットリオ・アルミニヨン	名詞,一般,*,*,*,*,*
翌年	名詞,副詞可能,*,*,*,*,翌年,ヨクネン,ヨクネン
元旦	名詞,一般,*,*,*,*,元旦,ガンタン,ガンタン
発効	名詞,サ変接続,*,*,*,*,発効,ハッコウ,ハッコー
蚕卵紙	名詞,一般,*,*,*,*,蚕卵紙,サンランシ,サンランシ
試験	名詞,サ変接続,*,*,*,*,試験,シケン,シケン
改良	名詞,サ変接続,*,*,*,*,改良,カイリョウ,カイリョー
ルイ・パスツール	名詞,一般,*,*,*,*,*
微粒子	名詞,一般,*,*,*,*,微粒子,ビリュウシ,ビリューシ
病	名詞,接尾,一般,*,*,*,病,ビョウ,ビョー
養蚕	名詞,一般,*,*,*,*,養蚕,ヨウサン,ヨーサン
用地	名詞,一般,*,*,*,*,用地,ヨウチ,ヨーチ
取り返す	動詞,自立,*,*,五段・サ行,基本形,取り返す,トリカエス,トリカエス
逆	接頭詞,名詞接続,*,*,*,*,逆,ギャク,ギャク
おこっ	動詞,自立,*,*,五段・ラ行,連用タ接続,おこる,オコッ,オコッ
ロンバルド	名詞,一般,*,*,*,*,*
内訳	名詞,一般,*,*,*,*,内訳,ウチワケ,ウチワケ
信仰	名詞,サ変接続,*,*,*,*,信仰,シンコウ,シンコー
実践	名詞,サ変接続,*,*,*,*,実践,ジッセン,ジッセン
毎週	名詞,副詞可能,*,*,*,*,毎週,マイシュウ,マイシュー
回答	名詞,サ変接続,*,*,*,*,回答,カイトウ,カイトー
ユニオン・コルス	名詞,一般,*,*,*,*,*
ユニオン	名詞,一般,*,*,*,*,ユニオン,ユニオン,ユニオン
ミリュー	名詞,一般,*,*,*,*,*
カモッラ	名詞,一般,*,*,*,*,*
ンドランゲタ	名詞,一般,*,*,*,*,*
プッリャ	名詞,一般,*,*,*,*,*
サクラ・コロンナ・ウニータ	名詞,一般,*,*,*,*,*
シカーリ	名詞,固有名詞,一般,*,*,*,*
食す	動詞,自立,*,*,サ変・－スル,文語基本形,食する,ショクス,ショクス
限定	名詞,サ変接続,*,*,*,*,限定,ゲンテイ,ゲンテイ
ブラジル	名詞,固有名詞,地域,国,*,*,ブラジル,ブラジル,ブラジル
次ぎ	動詞,自立,*,*,五段・ガ行,連用形,次ぐ,ツギ,ツギ
番目	名詞,接尾,助数詞,*,*,*,番目,バンメ,バンメ
’	記号,括弧閉,*,*,*,*,’,’,’
‘	記号,括弧開,*,*,*,*,‘,‘,‘
書院	名詞,一般,*,*,*,*,書院,ショイン,ショイン
詳	名詞,一般,*,*,*,*,*
高等	名詞,形容動詞語幹,*,*,*,*,高等,コウトウ,コートー
平成	名詞,固有名詞,一般,*,*,*,平成,ヘイセイ,ヘイセイ
年度	名詞,接尾,助数詞,*,*,*,年度,ネンド,ネンド
久米	名詞,固有名詞,人名,姓,*,*,久米,クメ,クメ
邦武	名詞,固有名詞,人名,名,*,*,邦武,クニタケ,クニタケ
編	名詞,一般,*,*,*,*,編,ヘン,ヘン
田中	名詞,固有名詞,人名,姓,*,*,田中,タナカ,タナカ
彰	名詞,固有名詞,人名,名,*,*,彰,アキラ,アキラ
校	名詞,一般,*,*,*,*,校,コウ,コー
注	名詞,一般,*,*,*,*,注,チュウ,チュー
岩波書店	名詞,固有名詞,組織,*,*,*,岩波書店,イワナミショテン,イワナミショテン
岩波	名詞,固有名詞,組織,*,*,*,岩波,イワナミ,イワナミ
文庫	名詞,一般,*,*,*,*,文庫,ブンコ,ブンコ
頁	名詞,接尾,助数詞,*,*,*,頁,ページ,ページ
百科全書	名詞,一般,*,*,*,*,百科全書,ヒャッカゼンショ,ヒャッカゼンショ
相賀	名詞,固有名詞,地域,一般,*,*,相賀,ソウガ,ソーガ
徹夫	名詞,固有名詞,人名,名,*,*,徹夫,テツオ,テツオ
小学館	名詞,固有名詞,組織,*,*,*,小学館,ショウガクカン,ショーガクカン
ストックホルム	名詞,固有名詞,地域,一般,*,*,ストックホルム,ストックホルム,ストックホルム
平和	名詞,形容動詞語幹,*,*,*,*,平和,ヘイワ,ヘイワ
研究所	名詞,一般,*,*,*,*,研究所,ケンキュウジョ,ケンキュージョ
バリシア・クレキッチ	名詞,一般,*,*,*,*,*
一生	名詞,固有名詞,人名,名,*,*,一生,カズオ,カズオ
ドゥブロヴニク	名詞,一般,*,*,*,*,*
交易	名詞,サ変接続,*,*,*,*,交易,コウエキ,コーエキ
彩	名詞,一般,*,*,*,*,彩,イロドリ,イロドリ
流	名詞,接尾,一般,*,*,*,流,リュウ,リュー
外務省	名詞,固有名詞,組織,*,*,*,外務省,ガイムショウ,ガイムショー
”	記号,括弧閉,*,*,*,*,”,”,”
ランキング	名詞,一般,*,*,*,*,ランキング,ランキング,ランキング
推移	名詞,サ変接続,*,*,*,*,推移,スイイ,スイイ
映ら	動詞,自立,*,*,五段・ラ行,未然形,映る,ウツラ,ウツラ
川口	名詞,固有名詞,地域,一般,*,*,川口,カワグチ,カワグチ
マーン	名詞,一般,*,*,*,*,*
惠美	名詞,固有名詞,人名,名,*,*,惠美,エミ,エミ
相次ぐ	動詞,自立,*,*,五段・ガ行,基本形,相次ぐ,アイツグ,アイツグ
船	名詞,接尾,一般,*,*,*,船,セン,セン
責任	名詞,一般,*,*,*,*,責任,セキニン,セキニン
受け入れ	動詞,自立,*,*,一段,連用形,受け入れる,ウケイレ,ウケイレ
気持ち	名詞,一般,*,*,*,*,気持ち,キモチ,キモチ
空回り	名詞,サ変接続,*,*,*,*,空回り,カラマワリ,カラマワリ
ビジネス	名詞,一般,*,*,*,*,ビジネス,ビジネス,ビジネス
プレス	名詞,サ変接続,*,*,*,*,プレス,プレス,プレス
押し寄せる	動詞,自立,*,*,一段,基本形,押し寄せる,オシヨセル,オシヨセル
大波	名詞,一般,*,*,*,*,大波,オオナミ,オーナミ
明記	名詞,サ変接続,*,*,*,*,明記,メイキ,メイキ
ピュー	名詞,一般,*,*,*,*,*
資料	名詞,一般,*,*,*,*,資料,シリョウ,シリョー
アーカイブ	名詞,一般,*,*,*,*,アーカイブ,アーカイブ,アーカイブ
データ	名詞,一般,*,*,*,*,データ,データ,データ
防犯	名詞,一般,*,*,*,*,防犯,ボウハン,ボーハン
驚き	名詞,一般,*,*,*,*,驚き,オドロキ,オドロキ
珍	名詞,一般,*,*,*,*,珍,チン,チン
！	記号,一般,*,*,*,*,！,！,！
カラー	名詞,一般,*,*,*,*,カラー,カラー,カラー
決め方	名詞,一般,*,*,*,*,決め方,キメカタ,キメカタ
意外	名詞,形容動詞語幹,*,*,*,*,意外,イガイ,イガイ
選	名詞,接尾,一般,*,*,*,選,セン,セン
ウィクショナリー	名詞,一般,*,*,*,*,*
辞書	名詞,一般,*,*,*,*,辞書,ジショ,ジショ
プロジェクト	名詞,一般,*,*,*,*,プロジェクト,プロジェクト,プロジェクト
ポータル	名詞,固有名詞,一般,*,*,*,*
庭園	名詞,一般,*,*,*,*,庭園,テイエン,テイエン
イタリアーノ	名詞,一般,*,*,*,*,*
ウィキメディア・プロジェクト	名詞,一般,*,*,*,*,*
姉妹	名詞,一般,*,*,*,*,姉妹,シマイ,シマイ
ウィキブックス	名詞,一般,*,*,*,*,*
教科書	名詞,一般,*,*,*,*,教科書,キョウカショ,キョーカショ
解説	名詞,サ変接続,*,*,*,*,解説,カイセツ,カイセツ
ウィキクォート	名詞,一般,*,*,*,*,*
引用	名詞,サ変接続,*,*,*,*,引用,インヨウ,インヨー
句集	名詞,一般,*,*,*,*,句集,クシュウ,クシュー
ウィキソース	名詞,一般,*,*,*,*,*
原文	名詞,一般,*,*,*,*,原文,ゲンブン,ゲンブン
コモンズ	名詞,一般,*,*,*,*,*
カテゴリ	名詞,一般,*,*,*,*,カテゴリ,カテゴリ,カテゴリ
ウィキニュース	名詞,一般,*,*,*,*,*
ウィキバーシティ	名詞,一般,*,*,*,*,*
学習	名詞,サ変接続,*,*,*,*,学習,ガクシュウ,ガクシュー
ウィキボヤージュ	名詞,一般,*,*,*,*,*
ガイド	名詞,サ変接続,*,*,*,*,ガイド,ガイド,ガイド
局	名詞,接尾,一般,*,*,*,局,キョク,キョク
支局	名詞,一般,*,*,*,*,支局,シキョク,シキョク
博覧	名詞,サ変接続,*,*,*,*,博覧,ハクラン,ハクラン
コト	名詞,固有名詞,一般,*,*,*,コト,コト,コト
バンク	名詞,一般,*,*,*,*,バンク,バンク,バンク
ウィキメディア	名詞,一般,*,*,*,*,*
オープンストリートマップ	名詞,一般,*,*,*,*,*
典拠	名詞,一般,*,*,*,*,典拠,テンキョ,テンキョ
ウィキデータ	名詞,一般,*,*,*,*,*
旗	名詞,一般,*,*,*,*,旗,ハタ,ハタ
保存	名詞,サ変接続,*,*,*,*,保存,ホゾン,ホゾン
プレビュー	名詞,一般,*,*,*,*,プレビュー,プレビュー,プレビュー
忘れ	動詞,自立,*,*,一段,未然形,忘れる,ワスレ,ワスレ
版	名詞,一般,*,*,*,*,版,バン,バン
歴	名詞,接尾,一般,*,*,*,歴,レキ,レキ
年代	名詞,一般,*,*,*,*,年代,ネンダイ,ネンダイ
先史	名詞,一般,*,*,*,*,先史,センシ,センシ
文明	名詞,一般,*,*,*,*,文明,ブンメイ,ブンメイ
郵政	名詞,一般,*,*,*,*,郵政,ユウセイ,ユーセイ
生態	名詞,一般,*,*,*,*,生態,セイタイ,セイタイ
植物	名詞,一般,*,*,*,*,植物,ショクブツ,ショクブツ
大都市	名詞,一般,*,*,*,*,大都市,ダイトシ,ダイトシ
国立	名詞,一般,*,*,*,*,国立,コクリツ,コクリツ
公園	名詞,一般,*,*,*,*,公園,コウエン,コーエン
外交	名詞,一般,*,*,*,*,外交,ガイコウ,ガイコー
証券	名詞,一般,*,*,*,*,証券,ショウケン,ショーケン
租税	名詞,一般,*,*,*,*,租税,ソゼイ,ソゼイ
電信	名詞,一般,*,*,*,*,電信,デンシン,デンシン
動態	名詞,一般,*,*,*,*,動態,ドウタイ,ドータイ
身分	名詞,一般,*,*,*,*,身分,ミブン,ミブン
トレチェント	名詞,一般,*,*,*,*,*
デザイン	名詞,サ変接続,*,*,*,*,デザイン,デザイン,デザイン
フォークダンス	名詞,一般,*,*,*,*,フォークダンス,フォークダンス,フォークダンス
シンボル	名詞,一般,*,*,*,*,シンボル,シンボル,シンボル
モナコ	名詞,固有名詞,地域,国,*,*,モナコ,モナコ,モナコ
ベネルクス	名詞,一般,*,*,*,*,*
ルクセンブルク	名詞,固有名詞,地域,国,*,*,ルクセンブルク,ルクセンブルク,ルクセンブルク
リヒテンシュタイン	名詞,固有名詞,地域,国,*,*,リヒテンシュタイン,リヒテンシュタイン,リヒテンシュタイン
イベリア	名詞,固有名詞,地域,一般,*,*,イベリア,イベリア,イベリア
アンドラ	名詞,固有名詞,地域,国,*,*,アンドラ,アンドラ,アンドラ
セルビア	名詞,固有名詞,地域,国,*,*,セルビア,セルビア,セルビア
マケドニア	名詞,固有名詞,地域,一般,*,*,マケドニア,マケドニア,マケドニア
ボスニア・ヘルツェゴビナ	名詞,固有名詞,地域,国,*,*,ボスニア・ヘルツェゴビナ,ボスニアヘルツェゴビナ,ボスニアヘルツェゴビナ
スラヴ	名詞,一般,*,*,*,*,*
北欧	名詞,固有名詞,地域,一般,*,*,北欧,ホクオウ,ホクオー
スカンディナヴィア	名詞,一般,*,*,*,*,*
デンマーク	名詞,固有名詞,地域,国,*,*,デンマーク,デンマーク,デンマーク
スウェーデン	名詞,固有名詞,地域,国,*,*,スウェーデン,スウェーデン,スウェーデン
ノルウェー	名詞,固有名詞,地域,国,*,*,ノルウェー,ノルウェー,ノルウェー
フィンランド	名詞,固有名詞,地域,国,*,*,フィンランド,フィンランド,フィンランド
アイスランド	名詞,固有名詞,地域,国,*,*,アイスランド,アイスランド,アイスランド
ブリ	名詞,一般,*,*,*,*,ブリ,ブリ,ブリ
テン	名詞,一般,*,*,*,*,テン,テン,テン
諸島	名詞,一般,*,*,*,*,諸島,ショトウ,ショトー
アイルランド	名詞,固有名詞,地域,国,*,*,アイルランド,アイルランド,アイルランド
バルト	名詞,固有名詞,地域,一般,*,*,バルト,バルト,バルト
リトアニア	名詞,固有名詞,地域,国,*,*,リトアニア,リトアニア,リトアニア
ラトビア	名詞,固有名詞,地域,国,*,*,ラトビア,ラトビア,ラトビア
エストニア	名詞,固有名詞,地域,国,*,*,エストニア,エストニア,エストニア
ウクライナ	名詞,固有名詞,地域,国,*,*,ウクライナ,ウクライナ,ウクライナ
ベラルーシ	名詞,固有名詞,地域,国,*,*,ベラルーシ,ベラルーシ,ベラルーシ
ソビエト	名詞,固有名詞,地域,国,*,*,ソビエト,ソビエト,ソビエト
連邦	名詞,一般,*,*,*,*,連邦,レンポウ,レンポー
モルドバ	名詞,固有名詞,地域,国,*,*,モルドバ,モルドバ,モルドバ
ブルガリア	名詞,固有名詞,地域,国,*,*,ブルガリア,ブルガリア,ブルガリア
マジャル	名詞,一般,*,*,*,*,*
チェコ	名詞,固有名詞,地域,国,*,*,チェコ,チェコ,チェコ
スロバキア	名詞,固有名詞,地域,国,*,*,スロバキア,スロバキア,スロバキア
アブハジア	名詞,固有名詞,地域,一般,*,*,アブハジア,アブハジア,アブハジア
アルツァフ	名詞,一般,*,*,*,*,*
ナゴルノ・カラバフ	名詞,固有名詞,一般,*,*,*,*
沿	名詞,一般,*,*,*,*,*
ドニエストル	名詞,一般,*,*,*,*,*
キプロス	名詞,固有名詞,地域,国,*,*,キプロス,キプロス,キプロス
コソボ	名詞,固有名詞,地域,一般,*,*,コソボ,コソボ,コソボ
ドネツク	名詞,一般,*,*,*,*,*
人民	名詞,一般,*,*,*,*,人民,ジンミン,ジンミン
オセチア	名詞,固有名詞,地域,一般,*,*,オセチア,オセチア,オセチア
ルガンスク	名詞,一般,*,*,*,*,*
自治領	名詞,一般,*,*,*,*,自治領,ジチリョウ,ジチリョー
アクロティリ	名詞,一般,*,*,*,*,*
デケリア	名詞,一般,*,*,*,*,*
ガーンジー	名詞,一般,*,*,*,*,*
ガーンジー	名詞,固有名詞,地域,一般,*,*,*
ジブラルタル	名詞,固有名詞,地域,一般,*,*,ジブラルタル,ジブラルタル,ジブラルタル
ジャージー	名詞,一般,*,*,*,*,ジャージー,ジャージー,ジャージー
マン	名詞,固有名詞,地域,一般,*,*,マン,マン,マン
フェロー	名詞,一般,*,*,*,*,*
スヴァールバル	名詞,一般,*,*,*,*,*
オーランド	名詞,一般,*,*,*,*,オーランド,オーランド,オーランド
本土	名詞,一般,*,*,*,*,本土,ホンド,ホンド
原則	名詞,一般,*,*,*,*,原則,ゲンソク,ゲンソク
－	記号,一般,*,*,*,*,－,ヒク,ヒク
られ	動詞,接尾,*,*,一段,未然形,られる,ラレ,ラレ
アゼルバイジャン	名詞,固有名詞,地域,国,*,*,アゼルバイジャン,アゼルバイジャン,アゼルバイジャン
アルメニア	名詞,固有名詞,地域,国,*,*,アルメニア,アルメニア,アルメニア
カザフスタン	名詞,固有名詞,地域,国,*,*,カザフスタン,カザフスタン,カザフスタン
ジョージア	名詞,固有名詞,地域,一般,*,*,ジョージア,ジョージア,ジョージア
含ま	動詞,自立,*,*,五段・マ行,未然形,含む,フクマ,フクマ
れ	動詞,接尾,*,*,一段,未然形,れる,レ,レ
※	記号,一般,*,*,*,*,※,※,※
総会	名詞,一般,*,*,*,*,総会,ソウカイ,ソーカイ
オブザーバー	名詞,一般,*,*,*,*,オブザーバー,オブザーバー,オブザーバー
得る	動詞,非自立,*,*,一段,基本形,得る,エル,エル
過半	名詞,一般,*,*,*,*,過半,カハン,カハン
中央アジア	名詞,固有名詞,地域,一般,*,*,中央アジア,チュウオウアジア,チューオーアジア
属す	動詞,自立,*,*,五段・サ行,基本形,属す,ゾクス,ゾクス
エジプト	名詞,固有名詞,地域,国,*,*,エジプト,エジプト,エジプト
スーダン	名詞,固有名詞,地域,国,*,*,スーダン,スーダン,スーダン
西アフリカ	名詞,固有名詞,地域,一般,*,*,西アフリカ,ニシアフリカ,ニシアフリカ
ガーナ	名詞,固有名詞,地域,国,*,*,ガーナ,ガーナ,ガーナ
カーボベルデ	名詞,固有名詞,地域,国,*,*,カーボベルデ,カーボベルデ,カーボベルデ
ガンビア	名詞,固有名詞,地域,国,*,*,ガンビア,ガンビア,ガンビア
ギニア	名詞,固有名詞,地域,国,*,*,ギニア,ギニア,ギニア
ギニアビサウ	名詞,固有名詞,地域,国,*,*,ギニアビサウ,ギニアビサウ,ギニアビサウ
コートジボワール	名詞,固有名詞,地域,国,*,*,コートジボワール,コートジボワール,コートジボワール
シエラレオネ	名詞,固有名詞,地域,国,*,*,シエラレオネ,シエラレオネ,シエラレオネ
セネガル	名詞,固有名詞,地域,国,*,*,セネガル,セネガル,セネガル
トーゴ	名詞,固有名詞,地域,国,*,*,トーゴ,トーゴ,トーゴ
ナイジェリア	名詞,固有名詞,地域,国,*,*,ナイジェリア,ナイジェリア,ナイジェリア
ニジェール	名詞,固有名詞,地域,国,*,*,ニジェール,ニジェール,ニジェール
ブルキナファソ	名詞,固有名詞,地域,国,*,*,ブルキナファソ,ブルキナファソ,ブルキナファソ
ベナン	名詞,固有名詞,地域,国,*,*,ベナン,ベナン,ベナン
マリ	名詞,固有名詞,地域,国,*,*,マリ,マリ,マリ
モーリタニア	名詞,固有名詞,地域,国,*,*,モーリタニア,モーリタニア,モーリタニア
リベリア	名詞,固有名詞,地域,国,*,*,リベリア,リベリア,リベリア
ウガンダ	名詞,固有名詞,地域,国,*,*,ウガンダ,ウガンダ,ウガンダ
ケニア	名詞,固有名詞,地域,国,*,*,ケニア,ケニア,ケニア
コモロ	名詞,固有名詞,地域,国,*,*,コモロ,コモロ,コモロ
ザンビア	名詞,固有名詞,地域,国,*,*,ザンビア,ザンビア,ザンビア
ジブチ	名詞,固有名詞,地域,国,*,*,ジブチ,ジブチ,ジブチ
ジンバブエ	名詞,固有名詞,地域,国,*,*,ジンバブエ,ジンバブエ,ジンバブエ
セーシェル	名詞,固有名詞,地域,国,*,*,セーシェル,セーシェル,セーシェル
タンザニア	名詞,固有名詞,地域,国,*,*,タンザニア,タンザニア,タンザニア
ブルンジ	名詞,固有名詞,地域,国,*,*,ブルンジ,ブルンジ,ブルンジ
マダガスカル	名詞,固有名詞,地域,国,*,*,マダガスカル,マダガスカル,マダガスカル
マラウイ	名詞,固有名詞,地域,国,*,*,マラウイ,マラウイ,マラウイ
モーリシャス	名詞,固有名詞,地域,国,*,*,モーリシャス,モーリシャス,モーリシャス
モザンビーク	名詞,固有名詞,地域,国,*,*,モザンビーク,モザンビーク,モザンビーク
ルワンダ	名詞,固有名詞,地域,国,*,*,ルワンダ,ルワンダ,ルワンダ
アンゴラ	名詞,固有名詞,地域,国,*,*,アンゴラ,アンゴラ,アンゴラ
ガボン	名詞,固有名詞,地域,国,*,*,ガボン,ガボン,ガボン
カメルーン	名詞,固有名詞,地域,国,*,*,カメルーン,カメルーン,カメルーン
コンゴ	名詞,固有名詞,地域,国,*,*,コンゴ,コンゴ,コンゴ
サントメ・プリンシペ	名詞,固有名詞,地域,国,*,*,サントメ・プリンシペ,サントメプリンシペ,サントメプリンシペ
赤道ギニア	名詞,固有名詞,地域,国,*,*,赤道ギニア,セキドウギニア,セキドーギニア
チャド	名詞,固有名詞,地域,国,*,*,チャド,チャド,チャド
中央アフリカ	名詞,固有名詞,地域,国,*,*,中央アフリカ,チュウオウアフリカ,チューオーアフリカ
エスワティニ	名詞,一般,*,*,*,*,*
ナミビア	名詞,固有名詞,地域,国,*,*,ナミビア,ナミビア,ナミビア
ボツワナ	名詞,固有名詞,地域,国,*,*,ボツワナ,ボツワナ,ボツワナ
南アフリカ	名詞,固有名詞,地域,国,*,*,南アフリカ,ミナミアフリカ,ミナミアフリカ
レソト	名詞,固有名詞,地域,国,*,*,レソト,レソト,レソト
ジュバランド	名詞,一般,*,*,*,*,*
ソマリランド	名詞,一般,*,*,*,*,*
南西	名詞,一般,*,*,*,*,南西,ナンセイ,ナンセイ
サハラ	名詞,固有名詞,地域,一般,*,*,サハラ,サハラ,サハラ
プントランド	名詞,一般,*,*,*,*,*
離島	名詞,サ変接続,*,*,*,*,離島,リトウ,リトー
イエメン	名詞,固有名詞,地域,国,*,*,イエメン,イエメン,イエメン
ソコトラ	名詞,固有名詞,地域,一般,*,*,*
アブドゥルクーリー	名詞,固有名詞,地域,一般,*,*,*
パンテッレリーア	名詞,一般,*,*,*,*,*
ペラージェ	名詞,一般,*,*,*,*,*
セントヘレナ・アセンション	名詞,一般,*,*,*,*,*
トリスタンダクーニャ	名詞,一般,*,*,*,*,*
カナリア諸島	名詞,固有名詞,地域,一般,*,*,カナリア諸島,カナリアショトウ,カナリアショトー
セウタ	名詞,一般,*,*,*,*,*
メリリャ	名詞,一般,*,*,*,*,*
プラサス・デ・ソベラニア	名詞,一般,*,*,*,*,*
マヨット	名詞,一般,*,*,*,*,*
レ	名詞,一般,*,*,*,*,レ,レ,レ
インド洋	名詞,固有名詞,一般,*,*,*,インド洋,インドヨウ,インドヨー
無人島	名詞,一般,*,*,*,*,無人島,ムジントウ,ムジントー
マデイラ	名詞,一般,*,*,*,*,*
無主	名詞,一般,*,*,*,*,無主,ムシュ,ムシュ
ビル・タウィール	名詞,一般,*,*,*,*,*
列	名詞,一般,*,*,*,*,列,レツ,レツ
五十音	名詞,一般,*,*,*,*,五十音,ゴジュウオン,ゴジューオン
および	助詞,接続助詞,*,*,*,*,および,オヨビ,オヨビ
メンバー	名詞,一般,*,*,*,*,メンバー,メンバー,メンバー
五	名詞,数,*,*,*,*,五,ゴ,ゴ
中華人民共和国	名詞,固有名詞,地域,国,*,*,中華人民共和国,チュウカジンミンキョウワコク,チューカジンミンキョーワコク
途上	名詞,一般,*,*,*,*,途上,トジョウ,トジョー
インド	名詞,固有名詞,地域,国,*,*,インド,インド,インド
連合	名詞,固有名詞,組織,*,*,*,連合,レンゴウ,レンゴー
アルゼンチン	名詞,固有名詞,地域,国,*,*,アルゼンチン,アルゼンチン,アルゼンチン
オーストラリア	名詞,固有名詞,地域,国,*,*,オーストラリア,オーストラリア,オーストラリア
インドネシア	名詞,固有名詞,地域,国,*,*,インドネシア,インドネシア,インドネシア
サウジアラビア	名詞,固有名詞,地域,国,*,*,サウジアラビア,サウジアラビア,サウジアラビア
大韓民国	名詞,固有名詞,地域,国,*,*,大韓民国,ダイカンミンコク,ダイカンミンコク
韓国	名詞,固有名詞,地域,国,*,*,韓国,カンコク,カンコク
マケドニア共和国	名詞,固有名詞,地域,国,*,*,マケドニア共和国,マケドニアキョウワコク,マケドニアキョーワコク
潜在	名詞,サ変接続,*,*,*,*,潜在,センザイ,センザイ
元	名詞,接尾,一般,*,*,*,元,モト,モト
ニュージーランド	名詞,固有名詞,地域,国,*,*,ニュージーランド,ニュージーランド,ニュージーランド
チリ	名詞,固有名詞,地域,国,*,*,チリ,チリ,チリ
イスラエル	名詞,固有名詞,地域,国,*,*,イスラエル,イスラエル,イスラエル
申請	名詞,サ変接続,*,*,*,*,申請,シンセイ,シンセイ
コロンビア	名詞,固有名詞,地域,国,*,*,コロンビア,コロンビア,コロンビア
コスタリカ	名詞,固有名詞,地域,国,*,*,コスタリカ,コスタリカ,コスタリカ
パートナー	名詞,一般,*,*,*,*,パートナー,パートナー,パートナー
東ティモール	名詞,固有名詞,地域,一般,*,*,東ティモール,ヒガシティモール,ヒガシティモール
ロゴ	名詞,一般,*,*,*,*,ロゴ,ロゴ,ロゴ
ウルグアイ	名詞,固有名詞,地域,国,*,*,ウルグアイ,ウルグアイ,ウルグアイ
隠し	名詞,接尾,一般,*,*,*,隠し,カクシ,カクシ
メニュー	名詞,一般,*,*,*,*,メニュー,メニュー,メニュー
個人	名詞,一般,*,*,*,*,個人,コジン,コジン
用	名詞,接尾,一般,*,*,*,用,ヨウ,ヨー
ツール	名詞,固有名詞,地域,一般,*,*,ツール,ツール,ツール
自分	名詞,一般,*,*,*,*,自分,ジブン,ジブン
アドレス	名詞,一般,*,*,*,*,アドレス,アドレス,アドレス
なさ	動詞,自立,*,*,五段・サ行,未然形,なす,ナサ,ナサ
議論	名詞,サ変接続,*,*,*,*,議論,ギロン,ギロン
トーク	名詞,一般,*,*,*,*,トーク,トーク,トーク
投稿	名詞,サ変接続,*,*,*,*,投稿,トウコウ,トーコー
記録	名詞,サ変接続,*,*,*,*,記録,キロク,キロク
アカウント	名詞,一般,*,*,*,*,アカウント,アカウント,アカウント
作成	名詞,サ変接続,*,*,*,*,作成,サクセイ,サクセイ
勧め	動詞,自立,*,*,一段,連用形,勧める,ススメ,ススメ
必須	名詞,形容動詞語幹,*,*,*,*,必須,ヒッス,ヒッス
推奨	名詞,サ変接続,*,*,*,*,推奨,スイショウ,スイショー
名前	名詞,一般,*,*,*,*,名前,ナマエ,ナマエ
空間	名詞,一般,*,*,*,*,空間,クウカン,クーカン
本文	名詞,一般,*,*,*,*,本文,ホンブン,ホンブン
履歴	名詞,一般,*,*,*,*,履歴,リレキ,リレキ
文字	名詞,一般,*,*,*,*,文字,モジ,モジ
探す	動詞,自立,*,*,五段・サ行,基本形,探す,サガス,サガス
厳密	名詞,形容動詞語幹,*,*,*,*,厳密,ゲンミツ,ゲンミツ
一致	名詞,サ変接続,*,*,*,*,一致,イッチ,イッチ
すれ	動詞,自立,*,*,サ変・スル,仮定形,する,スレ,スレ
メイン	名詞,一般,*,*,*,*,メイン,メイン,メイン
入手	名詞,サ変接続,*,*,*,*,入手,ニュウシュ,ニューシュ
場所	名詞,一般,*,*,*,*,場所,バショ,バショ
コミュニティ・ポータル	名詞,一般,*,*,*,*,*
最近	名詞,副詞可能,*,*,*,*,最近,サイキン,サイキン
出来事	名詞,一般,*,*,*,*,出来事,デキゴト,デキゴト
背景	名詞,一般,*,*,*,*,背景,ハイケイ,ハイケイ
知る	動詞,自立,*,*,五段・ラ行,基本形,知る,シル,シル
新しい	形容詞,自立,*,*,形容詞・イ段,基本形,新しい,アタラシイ,アタラシイ
ウィキ	名詞,一般,*,*,*,*,*
更新	名詞,サ変接続,*,*,*,*,更新,コウシン,コーシン
無作為	名詞,一般,*,*,*,*,無作為,ムサクイ,ムサクイ
読み込む	動詞,自立,*,*,五段・マ行,基本形,読み込む,ヨミコム,ヨミコム
おまかせ	名詞,一般,*,*,*,*,おまかせ,オマカセ,オマカセ
練習	名詞,サ変接続,*,*,*,*,練習,レンシュウ,レンシュー
ウィキメディア・コモンズ	名詞,一般,*,*,*,*,*
アップ	名詞,サ変接続,*,*,*,*,アップ,アップ,アップ
ロード	名詞,一般,*,*,*,*,ロード,ロード,ロード
得る	動詞,自立,*,*,一段,基本形,得る,エル,エル
井戸端	名詞,一般,*,*,*,*,井戸端,イドバタ,イドバタ
お知らせ	名詞,サ変接続,*,*,*,*,お知らせ,オシラセ,オシラセ
ウィキペディア・ソフトウェア	名詞,一般,*,*,*,*,*
バグ	名詞,一般,*,*,*,*,バグ,バグ,バグ
寄付	名詞,サ変接続,*,*,*,*,寄付,キフ,キフ
財団	名詞,一般,*,*,*,*,財団,ザイダン,ザイダン
連絡	名詞,サ変接続,*,*,*,*,連絡,レンラク,レンラク
ツール	名詞,一般,*,*,*,*,ツール,ツール,ツール
ここ	名詞,代名詞,一般,*,*,*,ここ,ココ,ココ
ウィキページ	名詞,一般,*,*,*,*,*
関連付け	動詞,自立,*,*,一段,未然形,関連付ける,カンレンヅケ,カンレンズケ
データリポジトリ	名詞,一般,*,*,*,*,*
印刷	名詞,サ変接続,*,*,*,*,印刷,インサツ,インサツ
書き出し	名詞,一般,*,*,*,*,書き出し,カキダシ,カキダシ
ブック	名詞,一般,*,*,*,*,ブック,ブック,ブック
ダウンロード	名詞,サ変接続,*,*,*,*,ダウンロード,ダウンロード,ダウンロード
バージョン	名詞,一般,*,*,*,*,バージョン,バージョン,バージョン
良質	名詞,形容動詞語幹,*,*,*,*,良質,リョウシツ,リョーシツ
アブ	名詞,一般,*,*,*,*,アブ,アブ,アブ
ハズ	名詞,一般,*,*,*,*,ハズ,ハズ,ハズ
Италиа	名詞,一般,*,*,*,*,*
А	名詞,一般,*,*,*,*,*
ԥ	記号,一般,*,*,*,*,*
сшәа	名詞,固有名詞,組織,*,*,*,*
アチェ	名詞,一般,*,*,*,*,*
アディゲ	名詞,一般,*,*,*,*,*
Италие	名詞,一般,*,*,*,*,*
Адыгабзэ	名詞,一般,*,*,*,*,*
秀逸	名詞,形容動詞語幹,*,*,*,*,秀逸,シュウイツ,シューイツ
アフリカーンス	名詞,一般,*,*,*,*,*
アレマン	名詞,一般,*,*,*,*,*
アルタイ	名詞,固有名詞,一般,*,*,*,アルタイ,アルタイ,アルタイ
Италия	名詞,一般,*,*,*,*,*
Алтай	名詞,一般,*,*,*,*,*
тил	名詞,一般,*,*,*,*,*
アムハラ	名詞,一般,*,*,*,*,*
ጣልያን	記号,一般,*,*,*,*,*
አማርኛ	記号,一般,*,*,*,*,*
アラゴン	名詞,一般,*,*,*,*,*
古	接頭詞,名詞接続,*,*,*,*,古,コ,コ
アラビア	名詞,固有名詞,地域,一般,*,*,アラビア,アラビア,アラビア
إيطاليا	記号,一般,*,*,*,*,*
العربية	記号,一般,*,*,*,*,*
アラム	名詞,一般,*,*,*,*,*
ܐܝܛܠܝܐ	記号,一般,*,*,*,*,*
ܐܪܡܝܐ	記号,一般,*,*,*,*,*
الطاليان	記号,一般,*,*,*,*,*
الدارجة	記号,一般,*,*,*,*,*
ايطاليا	記号,一般,*,*,*,*,*
مصرى	記号,一般,*,*,*,*,*
アッサム	名詞,固有名詞,地域,一般,*,*,アッサム,アッサム,アッサム
ইটালী	記号,一般,*,*,*,*,*
অসমীয়া	記号,一般,*,*,*,*,*
アストゥリアス	名詞,一般,*,*,*,*,*
アヴァル	名詞,一般,*,*,*,*,*
Авар	名詞,一般,*,*,*,*,*
コタヴァ	名詞,一般,*,*,*,*,*
アワディー	名詞,一般,*,*,*,*,*
इटली	記号,一般,*,*,*,*,*
अवधी	記号,一般,*,*,*,*,*
アイマラ	名詞,一般,*,*,*,*,*
ایتالیا	記号,一般,*,*,*,*,*
تۆرکجه	記号,一般,*,*,*,*,*
バシキール	名詞,一般,*,*,*,*,*
Башҡортса	名詞,一般,*,*,*,*,*
バリ	名詞,固有名詞,地域,一般,*,*,バリ,バリ,バリ
バイエルン	名詞,固有名詞,地域,一般,*,*,バイエルン,バイエルン,バイエルン
サモギティア	名詞,一般,*,*,*,*,*
ビコール	名詞,一般,*,*,*,*,*
Італія	名詞,一般,*,*,*,*,*
Беларуская	名詞,一般,*,*,*,*,*
タラシケヴィツァ	名詞,固有名詞,一般,*,*,*,*
тарашкевіца	名詞,一般,*,*,*,*,*
Български	名詞,一般,*,*,*,*,*
भोजपुरी	記号,一般,*,*,*,*,*
ビス	名詞,一般,*,*,*,*,ビス,ビス,ビス
ラマ	名詞,固有名詞,人名,一般,*,*,ラマ,ラマ,ラマ
バン	名詞,一般,*,*,*,*,バン,バン,バン
バラ	名詞,一般,*,*,*,*,バラ,バラ,バラ
ベンガル	名詞,固有名詞,地域,一般,*,*,ベンガル,ベンガル,ベンガル
ইতালি	記号,一般,*,*,*,*,*
বাংলা	記号,一般,*,*,*,*,*
チベット	名詞,固有名詞,一般,*,*,*,チベット,チベット,チベット
ཨི་ཏ་ལི།	記号,一般,*,*,*,*,*
བོད་ཡིག	記号,一般,*,*,*,*,*
ビシュヌプリヤ・マニプリ	名詞,一般,*,*,*,*,*
বিষ্ণুপ্রিয়া	記号,一般,*,*,*,*,*
মণিপুরী	記号,一般,*,*,*,*,*
ブル	名詞,固有名詞,人名,姓,*,*,ブル,ブル,ブル
トン	名詞,固有名詞,人名,名,*,*,トン,トン,トン
ボスニア	名詞,固有名詞,地域,一般,*,*,ボスニア,ボスニア,ボスニア
ブギ	名詞,一般,*,*,*,*,ブギ,ブギ,ブギ
ᨕᨗᨈᨒᨗᨕ	記号,一般,*,*,*,*,*
ᨅᨔ	記号,一般,*,*,*,*,*
ᨕᨘᨁᨗ	記号,一般,*,*,*,*,*
ブリヤート	名詞,一般,*,*,*,*,*
Итали	名詞,一般,*,*,*,*,*
Буряад	名詞,一般,*,*,*,*,*
カタロニア	名詞,一般,*,*,*,*,*
チャバカノ	名詞,一般,*,*,*,*,*
閩東	名詞,一般,*,*,*,*,*
É	名詞,一般,*,*,*,*,*
̤	記号,一般,*,*,*,*,*
̄	記号,一般,*,*,*,*,*
チェチェン	名詞,固有名詞,地域,国,*,*,チェチェン,チェチェン,チェチェン
Нохчийн	名詞,一般,*,*,*,*,*
セブアノ	名詞,一般,*,*,*,*,*
チャモロ	名詞,固有名詞,人名,一般,*,*,チャモロ,チャモロ,チャモロ
チェロキー	名詞,固有名詞,一般,*,*,*,チェロキー,チェロキー,チェロキー
ᎢᏔᎵ	記号,一般,*,*,*,*,*
ᏣᎳᎩ	記号,一般,*,*,*,*,*
シャイアン	名詞,一般,*,*,*,*,*
クルド	名詞,固有名詞,地域,一般,*,*,クルド,クルド,クルド
ئیتالیا	記号,一般,*,*,*,*,*
کوردی	記号,一般,*,*,*,*,*
クリー	名詞,一般,*,*,*,*,*
ᐃᑕᓖ	記号,一般,*,*,*,*,*
ᓀᐦᐃᔭᐍᐏᐣ	記号,一般,*,*,*,*,*
クリミア・タタール	名詞,一般,*,*,*,*,*
カシューブ	名詞,一般,*,*,*,*,*
Їталї	名詞,一般,*,*,*,*,*
ꙗ	記号,一般,*,*,*,*,*
Словѣньскъ	名詞,一般,*,*,*,*,*
ⰔⰎⰑⰂⰡⰐⰠⰔⰍⰟ	記号,一般,*,*,*,*,*
チュヴァシ	名詞,一般,*,*,*,*,*
Чӑвашла	名詞,一般,*,*,*,*,*
ウェールズ	名詞,固有名詞,地域,一般,*,*,ウェールズ,ウェールズ,ウェールズ
ザザキ	名詞,一般,*,*,*,*,*
低地	名詞,一般,*,*,*,*,低地,テイチ,テイチ
ソルブ	名詞,一般,*,*,*,*,*
इटाली	記号,一般,*,*,*,*,*
डोटेली	記号,一般,*,*,*,*,*
ディベヒ	名詞,一般,*,*,*,*,*
އިޓަލީވިލާތް	記号,一般,*,*,*,*,*
ދިވެހިބަސް	記号,一般,*,*,*,*,*
ゾンカ	名詞,固有名詞,一般,*,*,*,ゾンカ,ゾンカ,ゾンカ
ཨྀཊ་ལི་	記号,一般,*,*,*,*,*
ཇོང་ཁ	記号,一般,*,*,*,*,*
エウェ	名詞,一般,*,*,*,*,*
ʋ	記号,一般,*,*,*,*,*
Ιταλία	名詞,一般,*,*,*,*,*
Ελληνικά	名詞,一般,*,*,*,*,*
エミリア・ロマーニャ	名詞,一般,*,*,*,*,*
エスペラント	名詞,一般,*,*,*,*,エスペラント,エスペラント,エスペラント
バスク	名詞,固有名詞,一般,*,*,*,バスク,バスク,バスク
エストレマドゥーラ	名詞,一般,*,*,*,*,*
ペルシア	名詞,一般,*,*,*,*,*
فارسی	記号,一般,*,*,*,*,*
フラ	名詞,一般,*,*,*,*,フラ,フラ,フラ
ヴォロ	名詞,一般,*,*,*,*,*
フィジー	名詞,固有名詞,地域,国,*,*,フィジー,フィジー,フィジー
アルピタン	名詞,一般,*,*,*,*,*
フリジア	名詞,一般,*,*,*,*,*
ガガウズ	名詞,一般,*,*,*,*,*
贛語	名詞,一般,*,*,*,*,*
意	名詞,一般,*,*,*,*,意,イ,イ
大利	名詞,固有名詞,地域,一般,*,*,大利,オオリ,オーリ
スコットランド	名詞,固有名詞,地域,国,*,*,スコットランド,スコットランド,スコットランド
ゲール	名詞,固有名詞,人名,名,*,*,ゲール,ゲール,ゲール
ガリシア	名詞,一般,*,*,*,*,*
グアラニー	名詞,一般,*,*,*,*,*
ẽ	名詞,一般,*,*,*,*,*
ゴア・コンカニ	名詞,一般,*,*,*,*,*
गोंयची	記号,一般,*,*,*,*,*
कोंकणी	記号,一般,*,*,*,*,*
ゴロンタロ	名詞,一般,*,*,*,*,*
𐌹𐍄𐌰𐌻𐌾𐌰	記号,一般,*,*,*,*,*
𐌲𐌿𐍄𐌹𐍃𐌺	記号,一般,*,*,*,*,*
グジャラート	名詞,一般,*,*,*,*,*
ઈટલી	記号,一般,*,*,*,*,*
ગુજરાતી	記号,一般,*,*,*,*,*
ハウサ	名詞,一般,*,*,*,*,*
ハワイ	名詞,固有名詞,地域,一般,*,*,ハワイ,ハワイ,ハワイ
ʻ	記号,一般,*,*,*,*,*
ヘブライ	名詞,固有名詞,一般,*,*,*,ヘブライ,ヘブライ,ヘブライ
איטליה	記号,一般,*,*,*,*,*
עברית	記号,一般,*,*,*,*,*
ヒンディー	名詞,一般,*,*,*,*,*
हिन्दी	記号,一般,*,*,*,*,*
フィジー・ヒンディー	名詞,一般,*,*,*,*,*
高地	名詞,一般,*,*,*,*,高地,コウチ,コーチ
ハイチ・クレオール	名詞,一般,*,*,*,*,*
Իտալիա	記号,一般,*,*,*,*,*
Հայերեն	記号,一般,*,*,*,*,*
Արեւմտահայերէն	記号,一般,*,*,*,*,*
インターリングア	名詞,一般,*,*,*,*,*
インター	名詞,一般,*,*,*,*,インター,インター,インター
リング	名詞,一般,*,*,*,*,リング,リング,リング
イボ	名詞,一般,*,*,*,*,*
イヌピアック	名詞,一般,*,*,*,*,*
イロカノ	名詞,一般,*,*,*,*,*
イングーシ	名詞,固有名詞,一般,*,*,*,イングーシ,イングーシ,イングーシ
ГӀалгӀай	名詞,一般,*,*,*,*,*
イド	名詞,一般,*,*,*,*,*
イヌクティトット	名詞,一般,*,*,*,*,*
ᐃᓄᒃᑎᑐᑦ	記号,一般,*,*,*,*,*
ジャマイカ・クレオール	名詞,一般,*,*,*,*,*
ジバン	名詞,一般,*,*,*,*,ジバン,ジバン,ジバン
ジャワ	名詞,固有名詞,地域,一般,*,*,ジャワ,ジャワ,ジャワ
იტალია	記号,一般,*,*,*,*,*
ქართული	記号,一般,*,*,*,*,*
カラカルパク	名詞,一般,*,*,*,*,*
カビル	名詞,一般,*,*,*,*,*
カバルド	名詞,一般,*,*,*,*,*
Италэ	名詞,一般,*,*,*,*,*
Адыгэбзэ	名詞,一般,*,*,*,*,*
ɩ	記号,一般,*,*,*,*,*
ɛ	記号,一般,*,*,*,*,*
キクユ	名詞,一般,*,*,*,*,*
カザフ	名詞,固有名詞,地域,一般,*,*,カザフ,カザフ,カザフ
Қазақша	名詞,一般,*,*,*,*,*
クメール	名詞,固有名詞,一般,*,*,*,クメール,クメール,クメール
អ៊ីតាលី	記号,一般,*,*,*,*,*
ភាសាខ្មែរ	記号,一般,*,*,*,*,*
カンナダ	名詞,一般,*,*,*,*,*
ಇಟಲಿ	記号,一般,*,*,*,*,*
ಕನ್ನಡ	記号,一般,*,*,*,*,*
이탈리아	記号,一般,*,*,*,*,*
コミ・ペルミャク	名詞,一般,*,*,*,*,*
Италья	名詞,一般,*,*,*,*,*
Перем	名詞,一般,*,*,*,*,*
коми	名詞,一般,*,*,*,*,*
カラチャイ・バルカル	名詞,一般,*,*,*,*,*
Къарачай	名詞,一般,*,*,*,*,*
малкъар	名詞,一般,*,*,*,*,*
カシミール	名詞,固有名詞,地域,一般,*,*,カシミール,カシミール,カシミール
اِٹَلی	記号,一般,*,*,*,*,*
कॉशुर	記号,一般,*,*,*,*,*
کٲشُر	記号,一般,*,*,*,*,*
コミ	名詞,一般,*,*,*,*,*
Коми	名詞,一般,*,*,*,*,*
コーン	名詞,一般,*,*,*,*,コーン,コーン,コーン
ウォール	名詞,固有名詞,地域,一般,*,*,ウォール,ウォール,ウォール
キルギス	名詞,固有名詞,地域,国,*,*,キルギス,キルギス,キルギス
Кыргызча	名詞,一般,*,*,*,*,*
ラディノ	名詞,一般,*,*,*,*,*
ラク	名詞,一般,*,*,*,*,*
Лакку	名詞,一般,*,*,*,*,*
レズギ	名詞,一般,*,*,*,*,*
Лезги	名詞,一般,*,*,*,*,*
リングア・フランカ・ノバ	名詞,一般,*,*,*,*,*
ガンダ	名詞,一般,*,*,*,*,*
リンブルフ	名詞,一般,*,*,*,*,*
リンガラ	名詞,一般,*,*,*,*,*
ラオ	名詞,一般,*,*,*,*,ラオ,ラオ,ラオ
ປະເທດອິຕາລີ	記号,一般,*,*,*,*,*
ລາວ	記号,一般,*,*,*,*,*
ラトガリア	名詞,一般,*,*,*,*,*
マドゥラ	名詞,一般,*,*,*,*,*
マイティリー	名詞,一般,*,*,*,*,*
मैथिली	記号,一般,*,*,*,*,*
バニュマス	名詞,一般,*,*,*,*,*
モクシャ	名詞,一般,*,*,*,*,*
Мокшень	名詞,一般,*,*,*,*,*
東部	名詞,一般,*,*,*,*,東部,トウブ,トーブ
Италий	名詞,一般,*,*,*,*,*
Олык	名詞,一般,*,*,*,*,*
марий	名詞,一般,*,*,*,*,*
マオリ	名詞,固有名詞,地域,一般,*,*,マオリ,マオリ,マオリ
ミナンカバウ	名詞,一般,*,*,*,*,*
マケドニア	名詞,固有名詞,地域,国,*,*,マケドニア,マケドニア,マケドニア
Италија	名詞,一般,*,*,*,*,*
Македонски	名詞,一般,*,*,*,*,*
マラヤーラム	名詞,一般,*,*,*,*,*
ഇറ്റലി	記号,一般,*,*,*,*,*
മലയാളം	記号,一般,*,*,*,*,*
モンゴル	名詞,固有名詞,地域,国,*,*,モンゴル,モンゴル,モンゴル
Монгол	名詞,一般,*,*,*,*,*
マニプリ	名詞,一般,*,*,*,*,*
ꯏꯇꯥꯂꯤ	記号,一般,*,*,*,*,*
ꯃꯤꯇꯩ	記号,一般,*,*,*,*,*
ꯂꯣꯟ	記号,一般,*,*,*,*,*
マラーティー	名詞,一般,*,*,*,*,*
मराठी	記号,一般,*,*,*,*,*
山地	名詞,一般,*,*,*,*,山地,サンチ,サンチ
Кырык	名詞,一般,*,*,*,*,*
мары	名詞,一般,*,*,*,*,*
マレー	名詞,固有名詞,地域,一般,*,*,マレー,マレー,マレー
ミランダ	名詞,一般,*,*,*,*,*
ミャンマー	名詞,固有名詞,地域,国,*,*,ミャンマー,ミャンマー,ミャンマー
အီတလီနိုင်ငံ	記号,一般,*,*,*,*,*
မြန်မာဘာသာ	記号,一般,*,*,*,*,*
エルジャ	名詞,一般,*,*,*,*,*
Мастор	名詞,一般,*,*,*,*,*
Эрзянь	名詞,一般,*,*,*,*,*
マーザンダラーン	名詞,一般,*,*,*,*,*
مازِرونی	記号,一般,*,*,*,*,*
ナウル	名詞,固有名詞,地域,国,*,*,ナウル,ナウル,ナウル
低	接頭詞,名詞接続,*,*,*,*,低,テイ,テイ
ザクセン	名詞,固有名詞,地域,一般,*,*,ザクセン,ザクセン,ザクセン
ネパール	名詞,固有名詞,地域,国,*,*,ネパール,ネパール,ネパール
नेपाली	記号,一般,*,*,*,*,*
ネワール	名詞,一般,*,*,*,*,*
नेपाल	記号,一般,*,*,*,*,*
भाषा	記号,一般,*,*,*,*,*
ニアス	名詞,一般,*,*,*,*,*
ニーノシュク	名詞,一般,*,*,*,*,*
ブークモール	名詞,一般,*,*,*,*,*
ノヴィアル	名詞,一般,*,*,*,*,*
ンコ	名詞,一般,*,*,*,*,*
ߌߕߊߟߌ߫	記号,一般,*,*,*,*,*
ߒߞߏ	記号,一般,*,*,*,*,*
ソト	名詞,固有名詞,一般,*,*,*,ソト,ソト,ソト
ナバホ	名詞,一般,*,*,*,*,*
ʼ	記号,一般,*,*,*,*,*
íí	名詞,固有名詞,組織,*,*,*,*
é	名詞,固有名詞,組織,*,*,*,*
ニャンジャ	名詞,一般,*,*,*,*,*
オック	名詞,一般,*,*,*,*,*
オロモ	名詞,一般,*,*,*,*,*
オディア	名詞,一般,*,*,*,*,*
ଇଟାଲୀ	記号,一般,*,*,*,*,*
ଓଡ଼ିଆ	記号,一般,*,*,*,*,*
オセット	名詞,一般,*,*,*,*,*
Ирон	名詞,一般,*,*,*,*,*
パンジャブ	名詞,固有名詞,地域,一般,*,*,パンジャブ,パンジャブ,パンジャブ
ਇਟਲੀ	記号,一般,*,*,*,*,*
ਪੰਜਾਬੀ	記号,一般,*,*,*,*,*
パンガシナン	名詞,固有名詞,地域,一般,*,*,パンガシナン,パンガシナン,パンガシナン
パンパン	名詞,一般,*,*,*,*,パンパン,パンパン,パンパン
ガ	名詞,一般,*,*,*,*,ガ,ガ,ガ
パピアメント	名詞,一般,*,*,*,*,*
ピカルディ	名詞,一般,*,*,*,*,*
ペンシルベニア	名詞,固有名詞,地域,一般,*,*,ペンシルベニア,ペンシルベニア,ペンシルベニア
プファルツ	名詞,一般,*,*,*,*,*
パーリ	名詞,一般,*,*,*,*,*
पालि	記号,一般,*,*,*,*,*
ノーフォーク	名詞,固有名詞,地域,一般,*,*,ノーフォーク,ノーフォーク,ノーフォーク
ピトケアン	名詞,一般,*,*,*,*,*
اٹلی	記号,一般,*,*,*,*,*
پنجابی	記号,一般,*,*,*,*,*
ポントス・ギリシャ	名詞,一般,*,*,*,*,*
Ποντιακά	名詞,一般,*,*,*,*,*
パシュトゥー	名詞,一般,*,*,*,*,*
اېټاليا	記号,一般,*,*,*,*,*
پښتو	記号,一般,*,*,*,*,*
ケチュア	名詞,一般,*,*,*,*,*
ロマンシュ	名詞,一般,*,*,*,*,*
ロマ	名詞,一般,*,*,*,*,*
ルンディ	名詞,一般,*,*,*,*,*
アルーマニア	名詞,一般,*,*,*,*,*
タラント	名詞,一般,*,*,*,*,*
Русский	名詞,一般,*,*,*,*,*
ルシン	名詞,一般,*,*,*,*,*
Русиньскый	名詞,一般,*,*,*,*,*
キニアルワンダ	名詞,一般,*,*,*,*,*
サンスクリット	名詞,一般,*,*,*,*,サンスクリット,サンスクリット,サンスクリット
संस्कृतम्	記号,一般,*,*,*,*,*
サハ	名詞,一般,*,*,*,*,*
Саха	名詞,一般,*,*,*,*,*
тыла	名詞,一般,*,*,*,*,*
サンターリー	名詞,一般,*,*,*,*,*
ᱤᱴᱟᱞᱤ	記号,一般,*,*,*,*,*
ᱥᱟᱱᱛᱟᱲᱤ	記号,一般,*,*,*,*,*
シンド	形容詞,自立,*,*,形容詞・アウオ段,ガル接続,シンドい,シンド,シンド
اٽلي	記号,一般,*,*,*,*,*
سنڌي	記号,一般,*,*,*,*,*
サーミ	名詞,一般,*,*,*,*,*
サンゴ	名詞,一般,*,*,*,*,サンゴ,サンゴ,サンゴ
セルボ・クロアチア	名詞,一般,*,*,*,*,*
српскохрватски	名詞,一般,*,*,*,*,*
タシルハイト	名詞,一般,*,*,*,*,*
シャン	名詞,一般,*,*,*,*,シャン,シャン,シャン
မိူင်းဢီႇတႃႇလီႇ	記号,一般,*,*,*,*,*
ၽႃႇသႃႇတႆး	記号,一般,*,*,*,*,*
シンハラ	名詞,一般,*,*,*,*,*
ඉතාලිය	記号,一般,*,*,*,*,*
සිංහල	記号,一般,*,*,*,*,*
シンプル	名詞,形容動詞語幹,*,*,*,*,シンプル,シンプル,シンプル
سرائیکی	記号,一般,*,*,*,*,*
サモア	名詞,固有名詞,地域,国,*,*,サモア,サモア,サモア
イナリ・サーミ	名詞,一般,*,*,*,*,*
ショナ	名詞,一般,*,*,*,*,*
ソ	名詞,固有名詞,一般,*,*,*,ソ,ソ,ソ
Српски	名詞,一般,*,*,*,*,*
スリナム	名詞,固有名詞,地域,国,*,*,スリナム,スリナム,スリナム
スワジ	名詞,一般,*,*,*,*,*
ザーターフリジア	名詞,一般,*,*,*,*,*
スンダ	名詞,一般,*,*,*,*,*
スワヒリ	名詞,一般,*,*,*,*,*
シレジア	名詞,一般,*,*,*,*,*
タミル	名詞,固有名詞,一般,*,*,*,タミル,タミル,タミル
இத்தாலி	記号,一般,*,*,*,*,*
தமிழ்	記号,一般,*,*,*,*,*
トゥル	名詞,一般,*,*,*,*,*
ತುಳು	記号,一般,*,*,*,*,*
テルグ	名詞,一般,*,*,*,*,*
ఇటలీ	記号,一般,*,*,*,*,*
తెలుగు	記号,一般,*,*,*,*,*
テトゥン	名詞,一般,*,*,*,*,*
タジク	名詞,固有名詞,地域,国,*,*,タジク,タジク,タジク
Итолиё	名詞,一般,*,*,*,*,*
Тоҷикӣ	名詞,一般,*,*,*,*,*
タイ	名詞,固有名詞,地域,国,*,*,タイ,タイ,タイ
ประเทศอิตาลี	記号,一般,*,*,*,*,*
ไทย	記号,一般,*,*,*,*,*
ティグリニア	名詞,一般,*,*,*,*,*
ኢጣልያ	記号,一般,*,*,*,*,*
ትግርኛ	記号,一般,*,*,*,*,*
トルクメン	名詞,一般,*,*,*,*,*
タガログ	名詞,固有名詞,一般,*,*,*,タガログ,タガログ,タガログ
ツワナ	名詞,固有名詞,一般,*,*,*,ツワナ,ツワナ,ツワナ
トンガ	名詞,固有名詞,地域,国,*,*,トンガ,トンガ,トンガ
トク・ピシン	名詞,一般,*,*,*,*,*
タロコ	名詞,一般,*,*,*,*,*
ツォンガ	名詞,一般,*,*,*,*,*
タタール	名詞,一般,*,*,*,*,*
Татарча	名詞,一般,*,*,*,*,*
トゥンブカ	名詞,一般,*,*,*,*,*
トウィ	名詞,一般,*,*,*,*,*
タヒチ	名詞,固有名詞,地域,一般,*,*,タヒチ,タヒチ,タヒチ
トゥヴァ	名詞,一般,*,*,*,*,*
Тыва	名詞,一般,*,*,*,*,*
дыл	名詞,一般,*,*,*,*,*
ウドムルト	名詞,一般,*,*,*,*,*
Удмурт	名詞,一般,*,*,*,*,*
ウイグル	名詞,固有名詞,地域,一般,*,*,ウイグル,ウイグル,ウイグル
ئىتالىيە	記号,一般,*,*,*,*,*
ئۇيغۇرچە	記号,一般,*,*,*,*,*
Українська	名詞,一般,*,*,*,*,*
ウルドゥー	名詞,一般,*,*,*,*,*
اطالیہ	記号,一般,*,*,*,*,*
اردو	記号,一般,*,*,*,*,*
ウズベク	名詞,固有名詞,地域,一般,*,*,ウズベク,ウズベク,ウズベク
ўзбекча	名詞,一般,*,*,*,*,*
ベンダ	名詞,一般,*,*,*,*,ベンダ,ベンダ,ベンダ
ヴェプス	名詞,一般,*,*,*,*,*
ベトナム	名詞,固有名詞,地域,国,*,*,ベトナム,ベトナム,ベトナム
Ý	名詞,一般,*,*,*,*,*
ヴォラピュク	名詞,一般,*,*,*,*,*
ワロン	名詞,一般,*,*,*,*,*
ワライ	名詞,一般,*,*,*,*,*
ウォロフ	名詞,一般,*,*,*,*,*
呉	名詞,固有名詞,地域,一般,*,*,呉,クレ,クレ
吴语	名詞,一般,*,*,*,*,*
カルムイク	名詞,一般,*,*,*,*,*
Италмудин	名詞,一般,*,*,*,*,*
Орн	名詞,一般,*,*,*,*,*
Хальмг	名詞,一般,*,*,*,*,*
コサ	名詞,一般,*,*,*,*,*
メグレル	名詞,一般,*,*,*,*,*
მარგალური	記号,一般,*,*,*,*,*
イディッシュ	名詞,一般,*,*,*,*,*
איטאליע	記号,一般,*,*,*,*,*
ייִדיש	記号,一般,*,*,*,*,*
ヨルバ	名詞,一般,*,*,*,*,*
チワン	名詞,一般,*,*,*,*,*
ゼーラント	名詞,一般,*,*,*,*,*
中国語	名詞,一般,*,*,*,*,中国語,チュウゴクゴ,チューゴクゴ
漢文	名詞,一般,*,*,*,*,漢文,カンブン,カンブン
義	名詞,一般,*,*,*,*,義,ギ,ギ
文言	名詞,一般,*,*,*,*,文言,モンゴン,モンゴン
閩南	名詞,一般,*,*,*,*,*
Í	名詞,一般,*,*,*,*,*
広東	名詞,固有名詞,地域,一般,*,*,広東,カントン,カントン
粵語	名詞,一般,*,*,*,*,*
ズールー	名詞,固有名詞,一般,*,*,*,ズールー,ズールー,ズールー
テキスト	名詞,一般,*,*,*,*,テキスト,テキスト,テキスト
クリエイティブ・コモンズ	名詞,一般,*,*,*,*,*
ライセンス	名詞,一般,*,*,*,*,ライセンス,ライセンス,ライセンス
追加	名詞,サ変接続,*,*,*,*,追加,ツイカ,ツイカ
適用	名詞,サ変接続,*,*,*,*,適用,テキヨウ,テキヨー
ポリシー	名詞,一般,*,*,*,*,ポリシー,ポリシー,ポリシー
モバイルビュー	名詞,一般,*,*,*,*,*
声明	名詞,サ変接続,*,*,*,*,声明,セイメイ,セイメイ
ショートカット	名詞,一般,*,*,*,*,ショートカット,ショートカット,ショートカット
ウィキポータル	名詞,一般,*,*,*,*,*
政体	名詞,一般,*,*,*,*,政体,セイタイ,セイタイ
当たり	名詞,一般,*,*,*,*,当たり,アタリ,アタリ
物価	名詞,一般,*,*,*,*,物価,ブッカ,ブッカ
上昇	名詞,サ変接続,*,*,*,*,上昇,ジョウショウ,ジョーショー
新着	名詞,一般,*,*,*,*,新着,シンチャク,シンチャク
ログ	名詞,サ変接続,*,*,*,*,ログ,ログ,ログ
エミリア・ロマーニャグランプリ	名詞,一般,*,*,*,*,*
パッパ・アル・ポモドーロ	名詞,一般,*,*,*,*,*
ディンノチェンツォ	名詞,一般,*,*,*,*,*
ダヴィッド・ディ・ドナテッロ	名詞,一般,*,*,*,*,*
パーネ・トスカーノ	名詞,一般,*,*,*,*,*
怪	名詞,一般,*,*,*,*,怪,カイ,カイ
僧	名詞,一般,*,*,*,*,僧,ソウ,ソー
ラスプーチン	名詞,一般,*,*,*,*,*
理事	名詞,一般,*,*,*,*,理事,リジ,リジ
決議	名詞,サ変接続,*,*,*,*,決議,ケツギ,ケツギ
グランプリ	名詞,一般,*,*,*,*,グランプリ,グランプリ,グランプリ
ジャスミン・テッサーリ	名詞,一般,*,*,*,*,*
コロンバ・パスクアーレ	名詞,一般,*,*,*,*,*
ファル	名詞,固有名詞,組織,*,*,*,ファル,ファル,ファル
サリ	名詞,固有名詞,組織,*,*,*,サリ,サリ,サリ
エリ	名詞,一般,*,*,*,*,エリ,エリ,エリ
ポーリ	名詞,一般,*,*,*,*,*
宮殿	名詞,一般,*,*,*,*,宮殿,キュウデン,キューデン
クマ	名詞,一般,*,*,*,*,クマ,クマ,クマ
物語	名詞,一般,*,*,*,*,物語,モノガタリ,モノガタリ
アンドレア・ボルドリーニ	名詞,一般,*,*,*,*,*
カレー	名詞,一般,*,*,*,*,カレー,カレー,カレー
包囲	名詞,サ変接続,*,*,*,*,包囲,ホウイ,ホーイ
カザレッキオ	名詞,一般,*,*,*,*,*
戦い	名詞,一般,*,*,*,*,戦い,タタカイ,タタカイ
ハンドレッドホース	名詞,一般,*,*,*,*,*
クリ	名詞,一般,*,*,*,*,クリ,クリ,クリ
木	名詞,一般,*,*,*,*,木,キ,キ
ヴェンティミーリア	名詞,固有名詞,地域,一般,*,*,*
駅	名詞,接尾,地域,*,*,*,駅,エキ,エキ
サンタ・マリア・デル・フィオーレ	名詞,一般,*,*,*,*,*
フィガロ	名詞,固有名詞,一般,*,*,*,フィガロ,フィガロ,フィガロ
結婚	名詞,サ変接続,*,*,*,*,結婚,ケッコン,ケッコン
トゥーランドット	名詞,一般,*,*,*,*,*
特産	名詞,一般,*,*,*,*,特産,トクサン,トクサン
温泉	名詞,一般,*,*,*,*,温泉,オンセン,オンセン
物	名詞,接尾,一般,*,*,*,物,ブツ,ブツ
災害	名詞,一般,*,*,*,*,災害,サイガイ,サイガイ
水域	名詞,一般,*,*,*,*,水域,スイイキ,スイイキ
地質	名詞,一般,*,*,*,*,地質,チシツ,チシツ
チンクエ・テッレ	名詞,一般,*,*,*,*,*
広場	名詞,一般,*,*,*,*,広場,ヒロバ,ヒロバ
区	名詞,接尾,地域,*,*,*,区,ク,ク
港町	名詞,固有名詞,一般,*,*,*,港町,ミナトチョウ,ミナトチョー
ユダヤ	名詞,固有名詞,地域,一般,*,*,ユダヤ,ユダヤ,ユダヤ
河川	名詞,一般,*,*,*,*,河川,カセン,カセン
山	名詞,一般,*,*,*,*,山,ヤマ,ヤマ
湖	名詞,一般,*,*,*,*,湖,ミズウミ,ミズウミ
湖沼	名詞,一般,*,*,*,*,湖沼,コショウ,コショー
革製品	名詞,一般,*,*,*,*,革製品,カワセイヒン,カワセイヒン
大理石	名詞,一般,*,*,*,*,大理石,ダイリセキ,ダイリセキ
カッラーラ	名詞,一般,*,*,*,*,*
年	名詞,一般,*,*,*,*,年,トシ,トシ
アヴィニョン	名詞,一般,*,*,*,*,*
アルプ	名詞,一般,*,*,*,*,*
マリティーム	名詞,固有名詞,地域,一般,*,*,*
考古	名詞,一般,*,*,*,*,考古,コウコ,コーコ
古都	名詞,一般,*,*,*,*,古都,コト,コト
サヴォワ	名詞,一般,*,*,*,*,*
題材	名詞,一般,*,*,*,*,題材,ダイザイ,ダイザイ
修道院	名詞,一般,*,*,*,*,修道院,シュウドウイン,シュードーイン
メディチ	名詞,一般,*,*,*,*,*
コンドッティエーレ	名詞,一般,*,*,*,*,*
革命	名詞,一般,*,*,*,*,革命,カクメイ,カクメイ
亡命	名詞,サ変接続,*,*,*,*,亡命,ボウメイ,ボーメイ
ジョルジョ・ナポリターノ	名詞,一般,*,*,*,*,*
司法官	名詞,一般,*,*,*,*,司法官,シホウカン,シホーカン
急進	名詞,サ変接続,*,*,*,*,急進,キュウシン,キューシン
中道右派	名詞,一般,*,*,*,*,中道右派,チュウドウウハ,チュードーウハ
共産	名詞,固有名詞,組織,*,*,*,共産,キョウサン,キョーサン
再建	名詞,サ変接続,*,*,*,*,再建,サイケン,サイケン
ロマーノ・プローディ	名詞,一般,*,*,*,*,*
防衛	名詞,サ変接続,*,*,*,*,防衛,ボウエイ,ボーエイ
勲章	名詞,一般,*,*,*,*,勲章,クンショウ,クンショー
兵器	名詞,一般,*,*,*,*,兵器,ヘイキ,ヘイキ
常任	名詞,サ変接続,*,*,*,*,常任,ジョウニン,ジョーニン
プレカリアート	名詞,一般,*,*,*,*,*
上場	名詞,サ変接続,*,*,*,*,上場,ジョウジョウ,ジョージョー
アニメ	名詞,一般,*,*,*,*,アニメ,アニメ,アニメ
スタジオ	名詞,一般,*,*,*,*,スタジオ,スタジオ,スタジオ
多	接頭詞,名詞接続,*,*,*,*,多,タ,タ
国籍	名詞,一般,*,*,*,*,国籍,コクセキ,コクセキ
ナポリ・サンパオロ	名詞,一般,*,*,*,*,*
保険	名詞,一般,*,*,*,*,保険,ホケン,ホケン
アルファ・ロメオ	名詞,一般,*,*,*,*,*
テレコム	名詞,固有名詞,組織,*,*,*,テレコム,テレコム,テレコム
テレコム・イタリア・モービレ	名詞,一般,*,*,*,*,*
ウィンド	名詞,一般,*,*,*,*,ウィンド,ウィンド,ウィンド
ブル	名詞,一般,*,*,*,*,ブル,ブル,ブル
エネル	名詞,一般,*,*,*,*,*
アジップ	名詞,一般,*,*,*,*,*
パルマラット	名詞,一般,*,*,*,*,*
バリラ	名詞,一般,*,*,*,*,*
スタル	名詞,一般,*,*,*,*,*
ブイトーニ	名詞,一般,*,*,*,*,*
菓子	名詞,一般,*,*,*,*,菓子,カシ,カシ
フェッレーロ	名詞,一般,*,*,*,*,*
飲料	名詞,一般,*,*,*,*,飲料,インリョウ,インリョー
イッリカッフェ	名詞,一般,*,*,*,*,*
イリー	名詞,一般,*,*,*,*,*
ラヴァッツァ	名詞,一般,*,*,*,*,*
カン	名詞,一般,*,*,*,*,カン,カン,カン
サンペレグリノ	名詞,一般,*,*,*,*,*
フィンメカニカ	名詞,一般,*,*,*,*,*
宇宙	名詞,一般,*,*,*,*,宇宙,ウチュウ,ウチュー
リア	名詞,一般,*,*,*,*,リア,リア,リア
オート・メラーラ	名詞,一般,*,*,*,*,*
ベルトーネ	名詞,一般,*,*,*,*,*
ピニンファリーナ	名詞,一般,*,*,*,*,*
ファッションデザイナー	名詞,一般,*,*,*,*,ファッションデザイナー,ファッションデザイナー,ファッションデザイナー
デザイナー	名詞,一般,*,*,*,*,デザイナー,デザイナー,デザイナー
フェラガモ	名詞,一般,*,*,*,*,*
ドルチェ	名詞,一般,*,*,*,*,*
ガッバーナ	名詞,一般,*,*,*,*,*
フェンディ	名詞,一般,*,*,*,*,*
エトロ	名詞,一般,*,*,*,*,*
ヴェルサーチ	名詞,一般,*,*,*,*,*
ボッテガ・ヴェネタ	名詞,一般,*,*,*,*,*
実業	名詞,一般,*,*,*,*,実業,ジツギョウ,ジツギョー
入る	動詞,自立,*,*,五段・ラ行,基本形,入る,ハイル,ハイル
イベント	名詞,一般,*,*,*,*,イベント,イベント,イベント
手芸	名詞,一般,*,*,*,*,手芸,シュゲイ,シュゲイ
賞	名詞,一般,*,*,*,*,賞,ショウ,ショー
書籍	名詞,一般,*,*,*,*,書籍,ショセキ,ショセキ
ダンス	名詞,サ変接続,*,*,*,*,ダンス,ダンス,ダンス
博物館	名詞,一般,*,*,*,*,博物館,ハクブツカン,ハクブツカン
画家	名詞,一般,*,*,*,*,画家,ガカ,ガカ
ラファエロ・サンティ	名詞,一般,*,*,*,*,*
ラファエロ	名詞,一般,*,*,*,*,*
ミケランジェロ・メリージ・ダ・カラヴァッジオ	名詞,一般,*,*,*,*,*
カラヴァッジォ	名詞,一般,*,*,*,*,*
フラ・アンジェリコ	名詞,一般,*,*,*,*,*
ジョット・ディ・ボンドーネ	名詞,一般,*,*,*,*,*
ジョット	名詞,一般,*,*,*,*,*
彫刻	名詞,サ変接続,*,*,*,*,彫刻,チョウコク,チョーコク
ドナテッロ	名詞,一般,*,*,*,*,*
オリビエーロ・トスカーニ	名詞,一般,*,*,*,*,*
フィリッポ・ブルネレスキ	名詞,一般,*,*,*,*,*
コロッセオ	名詞,一般,*,*,*,*,*
小説	名詞,一般,*,*,*,*,小説,ショウセツ,ショーセツ
ジョヴァンニ・ボッカッチョ	名詞,一般,*,*,*,*,*
ウンベルト・エーコ	名詞,一般,*,*,*,*,*
デカ	名詞,一般,*,*,*,*,デカ,デカ,デカ
メロン	名詞,一般,*,*,*,*,メロン,メロン,メロン
ピコ・デラ・ミランドラ	名詞,一般,*,*,*,*,*
マキャヴェリズム	名詞,一般,*,*,*,*,*
ジャンル	名詞,一般,*,*,*,*,ジャンル,ジャンル,ジャンル
歌手	名詞,一般,*,*,*,*,歌手,カシュ,カシュ
ルチアーノ・パヴァロッティ	名詞,一般,*,*,*,*,*
アンドレア・ボチェッリ	名詞,一般,*,*,*,*,*
ジョアキーノ・ロッシーニ	名詞,一般,*,*,*,*,*
カルロ・マリア・ジュリーニ	名詞,一般,*,*,*,*,*
ラウラ・パウジーニ	名詞,一般,*,*,*,*,*
プレミアータ・フォルネリア・マルコーニ	名詞,一般,*,*,*,*,*
スカラ座	名詞,固有名詞,組織,*,*,*,スカラ座,スカラザ,スカラザ
ライフ	名詞,一般,*,*,*,*,ライフ,ライフ,ライフ
イズ・ビューティフル	名詞,一般,*,*,*,*,*
シネマ	名詞,一般,*,*,*,*,シネマ,シネマ,シネマ
パラダイス	名詞,一般,*,*,*,*,パラダイス,パラダイス,パラダイス
ラストエンペラー	名詞,一般,*,*,*,*,*
ロベルト・ベニーニ	名詞,一般,*,*,*,*,*
ジュゼッペ・トルナトーレ	名詞,一般,*,*,*,*,*
ロベルト・ロッセリーニ	名詞,一般,*,*,*,*,*
俳優	名詞,一般,*,*,*,*,俳優,ハイユウ,ハイユー
ソフィア	名詞,固有名詞,地域,一般,*,*,ソフィア,ソフィア,ソフィア
ローレン	名詞,固有名詞,一般,*,*,*,ローレン,ローレン,ローレン
モニカ・ベルッチ	名詞,一般,*,*,*,*,*
獅子	名詞,一般,*,*,*,*,獅子,シシ,シシ
生まれる	動詞,自立,*,*,一段,基本形,生まれる,ウマレル,ウマレル
酒類	名詞,一般,*,*,*,*,酒類,シュルイ,シュルイ
キャンティ	名詞,一般,*,*,*,*,*
アスティ	名詞,固有名詞,組織,*,*,*,アスティ,アスティ,アスティ
モッツァレッラ	名詞,一般,*,*,*,*,*
ペコリーノ	名詞,一般,*,*,*,*,*
食材	名詞,一般,*,*,*,*,食材,ショクザイ,ショクザイ
類	名詞,接尾,一般,*,*,*,類,ルイ,ルイ
ティラ・ミ・ス	名詞,一般,*,*,*,*,*
パネットーネ	名詞,一般,*,*,*,*,*
パンナ・コッタ	名詞,一般,*,*,*,*,*
アーリオ・オーリオ・ペペロンチーノ	名詞,一般,*,*,*,*,*
アラビアータ	名詞,一般,*,*,*,*,*
ラザニア	名詞,一般,*,*,*,*,*
カレンダー	名詞,一般,*,*,*,*,カレンダー,カレンダー,カレンダー
フィオレンティーナ	名詞,一般,*,*,*,*,*
ラツィオ	名詞,一般,*,*,*,*,*
スクーデリア・イタリア	名詞,一般,*,*,*,*,*
スクーデリア・トロ・ロッソ	名詞,一般,*,*,*,*,*
年中	名詞,副詞可能,*,*,*,*,年中,ネンジュウ,ネンジュー
行事	名詞,一般,*,*,*,*,行事,ギョウジ,ギョージ
インフラ	名詞,一般,*,*,*,*,インフラ,インフラ,インフラ
システム	名詞,一般,*,*,*,*,システム,システム,システム
水運	名詞,一般,*,*,*,*,水運,スイウン,スイウン
峠	名詞,一般,*,*,*,*,峠,トウゲ,トーゲ
バス	名詞,一般,*,*,*,*,バス,バス,バス
美術館	名詞,一般,*,*,*,*,美術館,ビジュツカン,ビジュツカン
ウフィツィ	名詞,一般,*,*,*,*,*
アカデミア	名詞,一般,*,*,*,*,*
ブレラ	名詞,一般,*,*,*,*,*
館	名詞,接尾,一般,*,*,*,館,カン,カン
カポディモンテ	名詞,一般,*,*,*,*,*
現	名詞,一般,*,*,*,*,現,ゲン,ゲン
バレンタインデー	名詞,一般,*,*,*,*,バレンタインデー,バレンタインデー,バレンタインデー
不定期	名詞,一般,*,*,*,*,不定期,フテイキ,フテイキ
メーデー	名詞,一般,*,*,*,*,メーデー,メーデー,メーデー
母	名詞,一般,*,*,*,*,母,ハハ,ハハ
依頼	名詞,サ変接続,*,*,*,*,依頼,イライ,イライ
アスプロモンテ	名詞,一般,*,*,*,*,*
変	名詞,形容動詞語幹,*,*,*,*,変,ヘン,ヘン
クストーツァ	名詞,一般,*,*,*,*,*
ビコッカ	名詞,一般,*,*,*,*,*
カストロ	名詞,固有名詞,人名,姓,*,*,カストロ,カストロ,カストロ
公国	名詞,一般,*,*,*,*,公国,コウコク,コーコク
ルッカ	名詞,一般,*,*,*,*,*
ソーラ	名詞,一般,*,*,*,*,*
フェラーラ	名詞,一般,*,*,*,*,*
チェーネダ	名詞,一般,*,*,*,*,*
マッサ・エ・カッラーラ	名詞,一般,*,*,*,*,*
ストロッツィ	名詞,一般,*,*,*,*,*
レジスタンス	名詞,一般,*,*,*,*,レジスタンス,レジスタンス,レジスタンス
オベルテンギ	名詞,一般,*,*,*,*,*
コンカ・ドーロ	名詞,一般,*,*,*,*,*
パンターリカ	名詞,一般,*,*,*,*,*
フィウーメ	名詞,一般,*,*,*,*,*
アルバーノ	名詞,一般,*,*,*,*,*
キアナ	名詞,一般,*,*,*,*,*
渓谷	名詞,一般,*,*,*,*,渓谷,ケイコク,ケイコク
バルディキアナ	名詞,一般,*,*,*,*,*
ヴァルディキアナ	名詞,一般,*,*,*,*,*
天道	名詞,一般,*,*,*,*,天道,テントウ,テントー
ガルガーノ	名詞,一般,*,*,*,*,*
カッシーナ・アマタ	名詞,一般,*,*,*,*,*
々	記号,一般,*,*,*,*,々,々,々
リオーネ	名詞,一般,*,*,*,*,*
サン	名詞,一般,*,*,*,*,サン,サン,サン
マルコ	名詞,固有名詞,組織,*,*,*,マルコ,マルコ,マルコ
カント・ア・テノーレ	名詞,一般,*,*,*,*,*
テノーレス	名詞,一般,*,*,*,*,*
ロッコ・バロッコ	名詞,一般,*,*,*,*,*
アイスバーグ	名詞,一般,*,*,*,*,*
水兵	名詞,一般,*,*,*,*,水兵,スイヘイ,スイヘイ
将軍	名詞,一般,*,*,*,*,将軍,ショウグン,ショーグン
ラウリーア	名詞,一般,*,*,*,*,*
ルジェ	名詞,一般,*,*,*,*,*
セバスティアーノ・ツィアニ	名詞,一般,*,*,*,*,*
ミチェーレ・パリネロ	名詞,一般,*,*,*,*,*
ジュゼッペ・インパスター	名詞,一般,*,*,*,*,*
ペッピーノ	名詞,一般,*,*,*,*,*
･	名詞,サ変接続,*,*,*,*,*
インパスタート	名詞,一般,*,*,*,*,*
百	名詞,数,*,*,*,*,百,ヒャク,ヒャク
歩	名詞,接尾,助数詞,*,*,*,歩,ホ,ホ
モデル	名詞,一般,*,*,*,*,モデル,モデル,モデル
カルロ・マリア・マルティーニ	名詞,一般,*,*,*,*,*
ジュリオ・アルベローニ	名詞,一般,*,*,*,*,*
サーバ	名詞,一般,*,*,*,*,サーバ,サーバ,サーバ
学者	名詞,一般,*,*,*,*,学者,ガクシャ,ガクシャ
ルイジ・ランツィ	名詞,一般,*,*,*,*,*
現状	名詞,一般,*,*,*,*,現状,ゲンジョウ,ゲンジョー
サブ	名詞,一般,*,*,*,*,サブ,サブ,サブ
ミケーレ・ノヴァーロ	名詞,一般,*,*,*,*,*
ピエロ・ウミリアーニ	名詞,一般,*,*,*,*,*
アンナ・オクサ	名詞,一般,*,*,*,*,*
クラウディオ・バリオーニ	名詞,一般,*,*,*,*,*
ジョヴァノッティ	名詞,一般,*,*,*,*,*
パオラ・エ・キアーラ	名詞,一般,*,*,*,*,*
カルメン・コンソリ	名詞,一般,*,*,*,*,*
ヴァスコ・ロッシ	名詞,一般,*,*,*,*,*
パオラ・トゥルチ	名詞,一般,*,*,*,*,*
ジョルジャ	名詞,一般,*,*,*,*,*
アンナ・タタンジェロ	名詞,一般,*,*,*,*,*
アリーザ	名詞,一般,*,*,*,*,*
ミケーレ・ザッリッロ	名詞,一般,*,*,*,*,*
ネーリ・ペル・カーゾ	名詞,一般,*,*,*,*,*
ミエッタ	名詞,一般,*,*,*,*,*
マティア・バザール	名詞,一般,*,*,*,*,*
トスカ	名詞,一般,*,*,*,*,*
レナート・ゼーロ	名詞,一般,*,*,*,*,*
テレビ	名詞,一般,*,*,*,*,テレビ,テレビ,テレビ
ラウラ・ベッティ	名詞,一般,*,*,*,*,*
ヴァンナ・マルキ	名詞,一般,*,*,*,*,*
ヴェロニカ・ラリオ	名詞,一般,*,*,*,*,*
マリア	名詞,固有名詞,一般,*,*,*,マリア,マリア,マリア
キティー・ガブリエル	名詞,一般,*,*,*,*,*
ニコラ・ザペッティ	名詞,一般,*,*,*,*,*
フランチェスカ・ダニ	名詞,一般,*,*,*,*,*
コス	名詞,固有名詞,人名,姓,*,*,コス,コス,コス
アルベルタ・フェレッティ	名詞,一般,*,*,*,*,*
アレッサンドロ・デラクア	名詞,一般,*,*,*,*,*
ラウラ・ビアジョッティ	名詞,一般,*,*,*,*,*
ピエトロ・ラーバ	名詞,一般,*,*,*,*,*
高層	名詞,一般,*,*,*,*,高層,コウソウ,コーソー
ビル	名詞,一般,*,*,*,*,ビル,ビル,ビル
ランケルスタイン	名詞,一般,*,*,*,*,*
城	名詞,接尾,一般,*,*,*,城,ジョウ,ジョー
コルシーニ	名詞,一般,*,*,*,*,*
エステンセ	名詞,一般,*,*,*,*,*
エステ	名詞,一般,*,*,*,*,エステ,エステ,エステ
サン・ジョルジョ	名詞,一般,*,*,*,*,*
ディアマンティ	名詞,一般,*,*,*,*,*
サクラ・コローナ・ウニータ	名詞,一般,*,*,*,*,*
モスキーノ	名詞,一般,*,*,*,*,*
フェレンツェ	名詞,一般,*,*,*,*,*
スコッピオデルカッロ	名詞,一般,*,*,*,*,*
大学	名詞,一般,*,*,*,*,大学,ダイガク,ダイガク
レーシング	名詞,一般,*,*,*,*,*
ハリーズ・バー	名詞,一般,*,*,*,*,*
ヴェネチア	名詞,一般,*,*,*,*,*
ジャーナリスト	名詞,一般,*,*,*,*,ジャーナリスト,ジャーナリスト,ジャーナリスト
協会	名詞,一般,*,*,*,*,協会,キョウカイ,キョーカイ
かけ	動詞,自立,*,*,一段,連用形,かける,カケ,カケ
提供	名詞,サ変接続,*,*,*,*,提供,テイキョウ,テイキョー
思う	動詞,自立,*,*,五段・ワ行促音便,基本形,思う,オモウ,オモウ
方	名詞,非自立,一般,*,*,*,方,ホウ,ホー
ウィキポータル	名詞,固有名詞,一般,*,*,*,*
書か	動詞,自立,*,*,五段・カ行イ音便,未然形,書く,カカ,カカ
自薦	名詞,サ変接続,*,*,*,*,自薦,ジセン,ジセン
他薦	名詞,サ変接続,*,*,*,*,他薦,タセン,タセン
問い	動詞,自立,*,*,五段・ワ行促音便,連用形,問う,トイ,トイ
既存	名詞,サ変接続,*,*,*,*,既存,キソン,キソン
古い	形容詞,自立,*,*,形容詞・アウオ段,基本形,古い,フルイ,フルイ
転記	名詞,サ変接続,*,*,*,*,転記,テンキ,テンキ
索引	名詞,一般,*,*,*,*,索引,サクイン,サクイン
使う	動詞,自立,*,*,五段・ワ行促音便,基本形,使う,ツカウ,ツカウ
張り	動詞,自立,*,*,五段・ラ行,連用形,張る,ハリ,ハリ
少し	副詞,助詞類接続,*,*,*,*,少し,スコシ,スコシ
軽減	名詞,サ変接続,*,*,*,*,軽減,ケイゲン,ケイゲン
ましょ	助動詞,*,*,*,特殊・マス,未然ウ接続,ます,マショ,マショ
点	名詞,非自立,一般,*,*,*,点,テン,テン
含ん	動詞,自立,*,*,五段・マ行,連用タ接続,含む,フクン,フクン
あなた	名詞,代名詞,一般,*,*,*,あなた,アナタ,アナタ
歓迎	名詞,サ変接続,*,*,*,*,歓迎,カンゲイ,カンゲイ
人文	名詞,一般,*,*,*,*,人文,ジンブン,ジンブン
伝	名詞,接尾,一般,*,*,*,伝,デン,デン
仏教	名詞,一般,*,*,*,*,仏教,ブッキョウ,ブッキョー
神道	名詞,一般,*,*,*,*,神道,シントウ,シントー
教	名詞,一般,*,*,*,*,教,キョウ,キョー
イスラーム	名詞,固有名詞,一般,*,*,*,イスラーム,イスラーム,イスラーム
スピリチュアリティ	名詞,一般,*,*,*,*,*
大	名詞,接尾,一般,*,*,*,大,ダイ,ダイ
東亜	名詞,固有名詞,地域,一般,*,*,東亜,トウア,トーア
共栄	名詞,サ変接続,*,*,*,*,共栄,キョウエイ,キョーエイ
ニューヨーク	名詞,固有名詞,地域,一般,*,*,ニューヨーク,ニューヨーク,ニューヨーク
東南アジア	名詞,固有名詞,地域,一般,*,*,東南アジア,トウナンアジア,トーナンアジア
朝鮮	名詞,固有名詞,地域,国,*,*,朝鮮,チョウセン,チョーセン
都道府県	名詞,一般,*,*,*,*,都道府県,トドウフケン,トドーフケン
法学	名詞,一般,*,*,*,*,法学,ホウガク,ホーガク
会計	名詞,サ変接続,*,*,*,*,会計,カイケイ,カイケイ
物理	名詞,一般,*,*,*,*,物理,ブツリ,ブツリ
生物	名詞,一般,*,*,*,*,生物,セイブツ,セイブツ
生き物	名詞,一般,*,*,*,*,生き物,イキモノ,イキモノ
鳥類	名詞,一般,*,*,*,*,鳥類,チョウルイ,チョールイ
昆虫	名詞,一般,*,*,*,*,昆虫,コンチュウ,コンチュー
地球	名詞,一般,*,*,*,*,地球,チキュウ,チキュー
気象	名詞,一般,*,*,*,*,気象,キショウ,キショー
天文学	名詞,一般,*,*,*,*,天文学,テンモンガク,テンモンガク
数学	名詞,一般,*,*,*,*,数学,スウガク,スーガク
医学	名詞,一般,*,*,*,*,医学,イガク,イガク
エレクトロニクス	名詞,一般,*,*,*,*,エレクトロニクス,エレクトロニクス,エレクトロニクス
コンピュータ	名詞,一般,*,*,*,*,コンピュータ,コンピュータ,コンピュータ
環境	名詞,一般,*,*,*,*,環境,カンキョウ,カンキョー
書物	名詞,一般,*,*,*,*,書物,ショモツ,ショモツ
スケート	名詞,一般,*,*,*,*,スケート,スケート,スケート
ラジオ	名詞,一般,*,*,*,*,ラジオ,ラジオ,ラジオ
手塚	名詞,固有名詞,人名,姓,*,*,手塚,テヅカ,テズカ
治虫	名詞,固有名詞,人名,名,*,*,治虫,オサム,オサム
ゲーム	名詞,一般,*,*,*,*,ゲーム,ゲーム,ゲーム
スカウト	名詞,一般,*,*,*,*,スカウト,スカウト,スカウト
認識	名詞,サ変接続,*,*,*,*,認識,ニンシキ,ニンシキ
処理	名詞,サ変接続,*,*,*,*,処理,ショリ,ショリ
江戸	名詞,固有名詞,地域,一般,*,*,江戸,エド,エド
ドラマ	名詞,一般,*,*,*,*,ドラマ,ドラマ,ドラマ
神話	名詞,一般,*,*,*,*,神話,シンワ,シンワ
ディズニー	名詞,固有名詞,組織,*,*,*,ディズニー,ディズニー,ディズニー
音響	名詞,一般,*,*,*,*,音響,オンキョウ,オンキョー
映像	名詞,一般,*,*,*,*,映像,エイゾウ,エイゾー
機器	名詞,一般,*,*,*,*,機器,キキ,キキ
お笑い	名詞,一般,*,*,*,*,お笑い,オワライ,オワライ
鉱物	名詞,一般,*,*,*,*,鉱物,コウブツ,コーブツ
宝石	名詞,一般,*,*,*,*,宝石,ホウセキ,ホーセキ
ベオグラード	名詞,固有名詞,地域,一般,*,*,ベオグラード,ベオグラード,ベオグラード
ヘヴィメタル	名詞,一般,*,*,*,*,*
柔道	名詞,一般,*,*,*,*,柔道,ジュウドウ,ジュードー
スペキュレイティブ・フィクション	名詞,一般,*,*,*,*,*
アイスホッケー	名詞,一般,*,*,*,*,アイスホッケー,アイスホッケー,アイスホッケー
横浜	名詞,固有名詞,地域,一般,*,*,横浜,ヨコハマ,ヨコハマ
ライト	名詞,一般,*,*,*,*,ライト,ライト,ライト
ノベル	名詞,一般,*,*,*,*,ノベル,ノベル,ノベル
玩具	名詞,一般,*,*,*,*,玩具,オモチャ,オモチャ
栄典	名詞,一般,*,*,*,*,栄典,エイテン,エイテン
フィットネス	名詞,一般,*,*,*,*,*
トラック	名詞,一般,*,*,*,*,トラック,トラック,トラック
農学	名詞,一般,*,*,*,*,農学,ノウガク,ノーガク
民俗	名詞,一般,*,*,*,*,民俗,ミンゾク,ミンゾク
貨幣	名詞,一般,*,*,*,*,貨幣,カヘイ,カヘイ
ヒンドゥー	名詞,一般,*,*,*,*,*
コンテンツ	名詞,一般,*,*,*,*,コンテンツ,コンテンツ,コンテンツ
王朝	名詞,一般,*,*,*,*,王朝,オウチョウ,オーチョー
発達	名詞,サ変接続,*,*,*,*,発達,ハッタツ,ハッタツ
オペレーティングシステム	名詞,一般,*,*,*,*,オペレーティングシステム,オペレーティングシステム,オペレーティングシステム
アイドル	名詞,一般,*,*,*,*,アイドル,アイドル,アイドル
仮	接頭詞,名詞接続,*,*,*,*,仮,カリ,カリ
بوابة	記号,一般,*,*,*,*,*
Портал	名詞,一般,*,*,*,*,*
Πύλη	名詞,一般,*,*,*,*,*
درگاه	記号,一般,*,*,*,*,*
Պորտալ	記号,一般,*,*,*,*,*
باب	記号,一般,*,*,*,*,*
土	名詞,接尾,一般,*,*,*,土,ド,ド
港	名詞,固有名詞,地域,一般,*,*,港,ミナト,ミナト
元麻布	名詞,固有名詞,地域,一般,*,*,元麻布,モトアザブ,モトアザブ
丁目	名詞,接尾,助数詞,*,*,*,丁目,チョウメ,チョーメ
−	名詞,サ変接続,*,*,*,*,*
クチコミ	名詞,一般,*,*,*,*,*
学院	名詞,一般,*,*,*,*,学院,ガクイン,ガクイン
語学	名詞,一般,*,*,*,*,語学,ゴガク,ゴガク
学校	名詞,一般,*,*,*,*,学校,ガッコウ,ガッコー
モスク	名詞,一般,*,*,*,*,モスク,モスク,モスク
名所	名詞,一般,*,*,*,*,名所,メイショ,メイショ
麻布	名詞,一般,*,*,*,*,麻布,マフ,マフ
複数	名詞,一般,*,*,*,*,複数,フクスウ,フクスー
礼拝	名詞,サ変接続,*,*,*,*,礼拝,レイハイ,レイハイ
センター	名詞,一般,*,*,*,*,センター,センター,センター
ムーア	名詞,一般,*,*,*,*,ムーア,ムーア,ムーア
ディテール	名詞,一般,*,*,*,*,ディテール,ディテール,ディテール
施さ	動詞,自立,*,*,五段・サ行,未然形,施す,ホドコサ,ホドコサ
静か	名詞,形容動詞語幹,*,*,*,*,静か,シズカ,シズカ
土曜日	名詞,副詞可能,*,*,*,*,土曜日,ドヨウビ,ドヨービ
定休	名詞,一般,*,*,*,*,定休,テイキュウ,テイキュー
日曜日	名詞,副詞可能,*,*,*,*,日曜日,ニチヨウビ,ニチヨービ
月曜日	名詞,副詞可能,*,*,*,*,月曜日,ゲツヨウビ,ゲツヨービ
時	名詞,接尾,助数詞,*,*,*,時,ジ,ジ
火曜日	名詞,副詞可能,*,*,*,*,火曜日,カヨウビ,カヨービ
水曜日	名詞,副詞可能,*,*,*,*,水曜日,スイヨウビ,スイヨービ
木曜日	名詞,副詞可能,*,*,*,*,木曜日,モクヨウビ,モクヨービ
金曜日	名詞,副詞可能,*,*,*,*,金曜日,キンヨウビ,キンヨービ
ゴールデンウィーク	名詞,一般,*,*,*,*,ゴールデンウィーク,ゴールデンウィーク,ゴールデンウィーク
昭和	名詞,固有名詞,一般,*,*,*,昭和,ショウワ,ショーワ
臨時	名詞,一般,*,*,*,*,臨時,リンジ,リンジ
休業	名詞,サ変接続,*,*,*,*,休業,キュウギョウ,キューギョー
枚	名詞,接尾,助数詞,*,*,*,枚,マイ,マイ
みんな	名詞,代名詞,一般,*,*,*,みんな,ミンナ,ミンナ
体験	名詞,サ変接続,*,*,*,*,体験,タイケン,タイケン
感想	名詞,一般,*,*,*,*,感想,カンソウ,カンソー
オーナー	名詞,一般,*,*,*,*,オーナー,オーナー,オーナー
オプション	名詞,一般,*,*,*,*,オプション,オプション,オプション
オンライン	名詞,一般,*,*,*,*,オンライン,オンライン,オンライン
レッスン	名詞,一般,*,*,*,*,レッスン,レッスン,レッスン
可	名詞,接尾,一般,*,*,*,可,カ,カ
安価	名詞,一般,*,*,*,*,安価,アンカ,アンカ
学べ	動詞,自立,*,*,一段,連用形,学べる,マナベ,マナベ
施設	名詞,サ変接続,*,*,*,*,施設,シセツ,シセツ
新宿	名詞,固有名詞,地域,一般,*,*,新宿,シンジュク,シンジュク
西新宿	名詞,固有名詞,地域,一般,*,*,西新宿,ニシシンジュク,ニシシンジュク
バークグレイス	名詞,一般,*,*,*,*,*
塾	名詞,一般,*,*,*,*,塾,ジュク,ジュク
営業	名詞,サ変接続,*,*,*,*,営業,エイギョウ,エイギョー
外	名詞,接尾,一般,*,*,*,外,ガイ,ガイ
パーク	名詞,一般,*,*,*,*,パーク,パーク,パーク
グレース	名詞,固有名詞,人名,名,*,*,グレース,グレース,グレース
三鷹	名詞,固有名詞,地域,一般,*,*,三鷹,ミタカ,ミタカ
新川	名詞,固有名詞,地域,一般,*,*,新川,シンカワ,シンカワ
アジア・アフリカ語学院	名詞,固有名詞,組織,*,*,*,アジア・アフリカ語学院,アジアアフリカゴガクイン,アジアアフリカゴガクイン
新川	名詞,固有名詞,組織,*,*,*,新川,シンカワ,シンカワ
財	名詞,接尾,一般,*,*,*,財,ザイ,ザイ
アラビック・コース	名詞,一般,*,*,*,*,*
不可	名詞,接尾,一般,*,*,*,不可,フカ,フカ
千代田	名詞,固有名詞,地域,一般,*,*,千代田,チヨダ,チヨダ
六番	名詞,固有名詞,地域,一般,*,*,六番,ロクバン,ロクバン
町	名詞,接尾,地域,*,*,*,町,マチ,マチ
ディラ	名詞,一般,*,*,*,*,*
アカデミー	名詞,一般,*,*,*,*,アカデミー,アカデミー,アカデミー
六	名詞,数,*,*,*,*,六,ロク,ロク
インドアビュー	名詞,一般,*,*,*,*,*
町	名詞,一般,*,*,*,*,町,マチ,マチ
実	接頭詞,名詞接続,*,*,*,*,実,ジツ,ジツ
店舗	名詞,一般,*,*,*,*,店舗,テンポ,テンポ
要	接頭詞,名詞接続,*,*,*,*,要,ヨウ,ヨー
マスク	名詞,一般,*,*,*,*,マスク,マスク,マスク
検温	名詞,サ変接続,*,*,*,*,検温,ケンオン,ケンオン
着用	名詞,サ変接続,*,*,*,*,着用,チャクヨウ,チャクヨー
バリアフリー	名詞,一般,*,*,*,*,バリアフリー,バリアフリー,バリアフリー
車椅子	名詞,一般,*,*,*,*,車椅子,クルマイス,クルマイス
入り口	名詞,一般,*,*,*,*,入り口,イリクチ,イリクチ
ウェブサイト	名詞,一般,*,*,*,*,*
記載	名詞,サ変接続,*,*,*,*,記載,キサイ,キサイ
目黒	名詞,固有名詞,地域,一般,*,*,目黒,メグロ,メグロ
東が丘	名詞,固有名詞,地域,一般,*,*,東が丘,ヒガシガオカ,ヒガシガオカ
上落合	名詞,固有名詞,地域,一般,*,*,上落合,カミオチアイ,カミオチアイ
番地	名詞,接尾,助数詞,*,*,*,番地,バンチ,バンチ
号	名詞,接尾,一般,*,*,*,号,ゴウ,ゴー
山武	名詞,固有名詞,地域,一般,*,*,山武,サンブ,サンブ
落合	名詞,固有名詞,地域,一般,*,*,落合,オチアイ,オチアイ
Ｆ	名詞,接尾,助数詞,*,*,*,Ｆ,エフ,エフ
／	記号,一般,*,*,*,*,／,／,／
Ｃ	記号,アルファベット,*,*,*,*,Ｃ,シー,シー
ジャパンーアラブ・インターナショナル・サービス	名詞,一般,*,*,*,*,*
ＪＡＩＳ	名詞,一般,*,*,*,*,*
オフィス	名詞,一般,*,*,*,*,オフィス,オフィス,オフィス
上落合	名詞,固有名詞,一般,*,*,*,上落合,カミオチアイ,カミオチアイ
カツラ	名詞,一般,*,*,*,*,カツラ,カツラ,カツラ
株	名詞,一般,*,*,*,*,株,カブ,カブ
シャムス	名詞,一般,*,*,*,*,*
（株）	名詞,一般,*,*,*,*,（株）,カブシキガイシャ,カブシキガイシャ
文京	名詞,固有名詞,地域,一般,*,*,文京,ブンキョウ,ブンキョー
本郷	名詞,固有名詞,地域,一般,*,*,本郷,ホンゴウ,ホンゴー
本郷	名詞,固有名詞,一般,*,*,*,本郷,ホンゴウ,ホンゴー
次	名詞,接尾,一般,*,*,*,次,ジ,ジ
顧客	名詞,一般,*,*,*,*,顧客,コキャク,コキャク
消毒	名詞,サ変接続,*,*,*,*,消毒,ショウドク,ショードク
渋谷	名詞,固有名詞,地域,一般,*,*,渋谷,シブヤ,シブヤ
大山	名詞,固有名詞,地域,一般,*,*,大山,オオヤマ,オーヤマ
ジャー	名詞,一般,*,*,*,*,ジャー,ジャー,ジャー
ミイ	名詞,固有名詞,一般,*,*,*,ミイ,ミイ,ミイ
書店	名詞,一般,*,*,*,*,書店,ショテン,ショテン
官庁	名詞,一般,*,*,*,*,官庁,カンチョウ,カンチョー
雑貨	名詞,一般,*,*,*,*,雑貨,ザッカ,ザッカ
店	名詞,接尾,一般,*,*,*,店,テン,テン
併設	名詞,サ変接続,*,*,*,*,併設,ヘイセツ,ヘイセツ
建て	動詞,自立,*,*,一段,未然形,建てる,タテ,タテ
様	名詞,接尾,人名,*,*,*,様,サマ,サマ
壮麗	名詞,形容動詞語幹,*,*,*,*,壮麗,ソウレイ,ソーレイ
見学	名詞,サ変接続,*,*,*,*,見学,ケンガク,ケンガク
受け付け	動詞,自立,*,*,一段,連用形,受け付ける,ウケツケ,ウケツケ
ハラルマーケット	名詞,一般,*,*,*,*,*
幾何	名詞,一般,*,*,*,*,幾何,キカ,キカ
模様	名詞,一般,*,*,*,*,模様,モヨウ,モヨー
カリグラフィー	名詞,一般,*,*,*,*,*
美しい	形容詞,自立,*,*,形容詞・イ段,基本形,美しい,ウツクシイ,ウツクシイ
五番	名詞,固有名詞,地域,一般,*,*,五番,ゴバン,ゴバン
階	名詞,接尾,助数詞,*,*,*,階,カイ,カイ
バークレー	名詞,固有名詞,地域,一般,*,*,バークレー,バークレー,バークレー
ハウス	名詞,一般,*,*,*,*,ハウス,ハウス,ハウス
市ヶ谷	名詞,固有名詞,人名,姓,*,*,市ヶ谷,イチガヤ,イチガヤ
校	名詞,接尾,一般,*,*,*,校,コウ,コー
ビル	名詞,固有名詞,人名,名,*,*,ビル,ビル,ビル
中央	名詞,固有名詞,地域,一般,*,*,中央,チュウオウ,チューオー
日本橋	名詞,固有名詞,地域,一般,*,*,日本橋,ニホンバシ,ニホンバシ
小網	名詞,固有名詞,地域,一般,*,*,小網,コアミ,コアミ
サウディアラビア	名詞,一般,*,*,*,*,*
茅場町	名詞,固有名詞,一般,*,*,*,茅場町,カヤバチョウ,カヤバチョー
高木	名詞,固有名詞,人名,姓,*,*,高木,タカギ,タカギ
芝大門	名詞,固有名詞,地域,一般,*,*,芝大門,シバダイモン,シバダイモン
玉	名詞,接尾,一般,*,*,*,玉,ダマ,ダマ
カルチャー	名詞,一般,*,*,*,*,カルチャー,カルチャー,カルチャー
芝	名詞,一般,*,*,*,*,芝,シバ,シバ
大門	名詞,一般,*,*,*,*,大門,オオモン,オーモン
玉	名詞,接尾,助数詞,*,*,*,玉,タマ,タマ
ワークスバーニングブルー	名詞,一般,*,*,*,*,*
エポコラム	名詞,一般,*,*,*,*,*
ロト	名詞,一般,*,*,*,*,*
駐車	名詞,サ変接続,*,*,*,*,駐車,チュウシャ,チューシャ
多摩	名詞,固有名詞,地域,一般,*,*,多摩,タマ,タマ
鶴牧	名詞,固有名詞,地域,一般,*,*,鶴牧,ツルマキ,ツルマキ
Ｌｉｎｋ	名詞,一般,*,*,*,*,*
松が谷	名詞,固有名詞,地域,一般,*,*,松が谷,マツガヤ,マツガヤ
神奈川	名詞,固有名詞,地域,一般,*,*,神奈川,カナガワ,カナガワ
ＩＣＣ	名詞,一般,*,*,*,*,*
外語	名詞,一般,*,*,*,*,外語,ガイゴ,ガイゴ
台	名詞,固有名詞,地域,一般,*,*,台,ウテナ,ウテナ
代々木	名詞,固有名詞,地域,一般,*,*,代々木,ヨヨギ,ヨヨギ
代々木	名詞,固有名詞,一般,*,*,*,代々木,ヨヨギ,ヨヨギ
海老名	名詞,固有名詞,地域,一般,*,*,海老名,エビナ,エビナ
上郷	名詞,固有名詞,地域,一般,*,*,上郷,カミゴウ,カミゴー
マスジド	名詞,一般,*,*,*,*,*
上郷	名詞,固有名詞,一般,*,*,*,上郷,カミゴウ,カミゴー
海老名	名詞,固有名詞,一般,*,*,*,海老名,エビナ,エビナ
ムスリム	名詞,固有名詞,一般,*,*,*,*
為	名詞,非自立,副詞可能,*,*,*,為,タメ,タメ
イマーム・ムハンマド・イブン・サウード・イスラーム	名詞,一般,*,*,*,*,*
分校	名詞,一般,*,*,*,*,分校,ブンコウ,ブンコー
六本木	名詞,固有名詞,地域,一般,*,*,六本木,ロッポンギ,ロッポンギ
八王子	名詞,固有名詞,地域,一般,*,*,八王子,ハチオウジ,ハチオージ
平岡	名詞,固有名詞,地域,一般,*,*,平岡,ヒラオカ,ヒラオカ
中	名詞,固有名詞,地域,一般,*,*,中,ナカ,ナカ
桜木	名詞,固有名詞,地域,一般,*,*,桜木,サクラギ,サクラギ
ユーラシア	名詞,固有名詞,地域,一般,*,*,ユーラシア,ユーラシア,ユーラシア
教室	名詞,一般,*,*,*,*,教室,キョウシツ,キョーシツ
桜木町	名詞,固有名詞,一般,*,*,*,桜木町,サクラギチョウ,サクラギチョー
マジック	名詞,一般,*,*,*,*,マジック,マジック,マジック
半	接頭詞,名詞接続,*,*,*,*,半,ハン,ハン
ヨルダン	名詞,固有名詞,地域,国,*,*,ヨルダン,ヨルダン,ヨルダン
レバノン	名詞,固有名詞,地域,国,*,*,レバノン,レバノン,レバノン
度重なる	動詞,自立,*,*,五段・ラ行,基本形,度重なる,タビカサナル,タビカサナル
ウェブブラウザ	名詞,一般,*,*,*,*,*
ソフト	名詞,一般,*,*,*,*,ソフト,ソフト,ソフト
اللغة	記号,一般,*,*,*,*,*
ɣ	記号,一般,*,*,*,*,*
‿	名詞,サ変接続,*,*,*,*,*
ʕ	記号,一般,*,*,*,*,*
首長	名詞,一般,*,*,*,*,首長,シュチョウ,シュチョー
イラン	名詞,固有名詞,地域,国,*,*,イラン,イラン,イラン
オマーン	名詞,固有名詞,地域,国,*,*,オマーン,オマーン,オマーン
カタール	名詞,固有名詞,地域,国,*,*,カタール,カタール,カタール
クウェート	名詞,固有名詞,地域,国,*,*,クウェート,クウェート,クウェート
パレスチナ	名詞,固有名詞,地域,一般,*,*,パレスチナ,パレスチナ,パレスチナ
ガザ	名詞,固有名詞,地域,一般,*,*,ガザ,ガザ,ガザ
ヨルダン川	名詞,固有名詞,一般,*,*,*,ヨルダン川,ヨルダンガワ,ヨルダンガワ
西岸	名詞,一般,*,*,*,*,西岸,セイガン,セイガン
バーレーン	名詞,固有名詞,地域,国,*,*,バーレーン,バーレーン,バーレーン
族	名詞,接尾,一般,*,*,*,族,ゾク,ゾク
アフロ・アジア	名詞,一般,*,*,*,*,*
語族	名詞,一般,*,*,*,*,語族,ゴゾク,ゴゾク
セム	名詞,固有名詞,一般,*,*,*,セム,セム,セム
西方	名詞,一般,*,*,*,*,西方,セイホウ,セイホー
公的	名詞,形容動詞語幹,*,*,*,*,公的,コウテキ,コーテキ
地位	名詞,一般,*,*,*,*,地位,チイ,チイ
連盟	名詞,一般,*,*,*,*,連盟,レンメイ,レンメイ
統制	名詞,サ変接続,*,*,*,*,統制,トウセイ,トーセイ
コード	名詞,一般,*,*,*,*,コード,コード,コード
マクロ	名詞,一般,*,*,*,*,マクロ,マクロ,マクロ
ランゲージ	名詞,一般,*,*,*,*,ランゲージ,ランゲージ,ランゲージ
個別	名詞,形容動詞語幹,*,*,*,*,個別,コベツ,コベツ
ドファール	名詞,一般,*,*,*,*,*
湾岸	名詞,一般,*,*,*,*,湾岸,ワンガン,ワンガン
ハドラマウト	名詞,一般,*,*,*,*,*
ヒジャーズ	名詞,一般,*,*,*,*,*
ナジュド	名詞,一般,*,*,*,*,*
サイード	名詞,一般,*,*,*,*,*
北イエメン	名詞,固有名詞,地域,国,*,*,北イエメン,キタイエメン,キタイエメン
シフフ	名詞,一般,*,*,*,*,*
フスハー	名詞,一般,*,*,*,*,*
南イエメン	名詞,固有名詞,地域,国,*,*,南イエメン,ミナミイエメン,ミナミイエメン
青	名詞,一般,*,*,*,*,青,アオ,アオ
水色	名詞,一般,*,*,*,*,水色,ミズイロ,ミズイロ
マイノリティ	名詞,一般,*,*,*,*,*
剌比	名詞,一般,*,*,*,*,*
アッ	感動詞,*,*,*,*,*,アッ,アッ,アッ
ルガトゥル	名詞,一般,*,*,*,*,*
アラビーヤ	名詞,一般,*,*,*,*,*
العَرَبِيَّة	記号,一般,*,*,*,*,*
ʔ	記号,一般,*,*,*,*,*
عَرَبِيّ	記号,一般,*,*,*,*,*
ˈʕ	記号,一般,*,*,*,*,*
主	名詞,形容動詞語幹,*,*,*,*,主,オモ,オモ
字	名詞,接尾,助数詞,*,*,*,字,ジ,ジ
表さ	動詞,自立,*,*,五段・サ行,未然形,表す,アラワサ,アラワサ
サハラ砂漠	名詞,固有名詞,一般,*,*,*,サハラ砂漠,サハラサバク,サハラサバク
以北	名詞,接尾,一般,*,*,*,以北,イホク,イホク
文法	名詞,一般,*,*,*,*,文法,ブンポウ,ブンポー
分布	名詞,サ変接続,*,*,*,*,分布,ブンプ,ブンプ
口語	名詞,一般,*,*,*,*,口語,コウゴ,コーゴ
語彙	名詞,一般,*,*,*,*,語彙,ゴイ,ゴイ
もともと	副詞,助詞類接続,*,*,*,*,もともと,モトモト,モトモト
方面	名詞,一般,*,*,*,*,方面,ホウメン,ホーメン
広がっ	動詞,自立,*,*,五段・ラ行,連用タ接続,広がる,ヒロガッ,ヒロガッ
次	名詞,一般,*,*,*,*,次,ツギ,ツギ
文語	名詞,一般,*,*,*,*,文語,ブンゴ,ブンゴ
昔	名詞,副詞可能,*,*,*,*,昔,ムカシ,ムカシ
もしくは	接続詞,*,*,*,*,*,もしくは,モシクハ,モシクワ
クルアーン	名詞,一般,*,*,*,*,*
正則	名詞,一般,*,*,*,*,正則,セイソク,セイソク
アーンミーヤ	名詞,一般,*,*,*,*,*
西暦	名詞,一般,*,*,*,*,西暦,セイレキ,セイレキ
さかのぼる	動詞,自立,*,*,五段・ラ行,基本形,さかのぼる,サカノボル,サカノボル
出現	名詞,サ変接続,*,*,*,*,出現,シュツゲン,シュツゲン
ともなっ	動詞,自立,*,*,五段・ワ行促音便,連用タ接続,ともなう,トモナッ,トモナッ
広がり	動詞,自立,*,*,五段・ラ行,連用形,広がる,ヒロガリ,ヒロガリ
聖典	名詞,一般,*,*,*,*,聖典,セイテン,セイテン
ムハンマド	名詞,一般,*,*,*,*,*
かなり	副詞,一般,*,*,*,*,かなり,カナリ,カナリ
反映	名詞,サ変接続,*,*,*,*,反映,ハンエイ,ハンエイ
記述	名詞,サ変接続,*,*,*,*,記述,キジュツ,キジュツ
伝える	動詞,自立,*,*,一段,基本形,伝える,ツタエル,ツタエル
神	名詞,一般,*,*,*,*,神,カミ,カミ
アッラー	名詞,一般,*,*,*,*,*
とらえ	動詞,自立,*,*,一段,連用形,とらえる,トラエ,トラエ
コーラン	名詞,一般,*,*,*,*,コーラン,コーラン,コーラン
詠唱	名詞,サ変接続,*,*,*,*,詠唱,エイショウ,エイショー
音韻	名詞,一般,*,*,*,*,音韻,オンイン,オンイン
ふむ	動詞,自立,*,*,五段・マ行,基本形,ふむ,フム,フム
原典	名詞,一般,*,*,*,*,原典,ゲンテン,ゲンテン
人類	名詞,一般,*,*,*,*,人類,ジンルイ,ジンルイ
禁じ	動詞,自立,*,*,一段,未然形,禁じる,キンジ,キンジ
勉強	名詞,サ変接続,*,*,*,*,勉強,ベンキョウ,ベンキョー
暗誦	名詞,サ変接続,*,*,*,*,暗誦,アンショウ,アンショー
敬虔	名詞,形容動詞語幹,*,*,*,*,敬虔,ケイケン,ケイケン
義務	名詞,一般,*,*,*,*,義務,ギム,ギム
学ぶ	動詞,自立,*,*,五段・バ行,基本形,学ぶ,マナブ,マナブ
必然	名詞,一般,*,*,*,*,必然,ヒツゼン,ヒツゼン
読め	動詞,自立,*,*,一段,未然形,読める,ヨメ,ヨメ
知識	名詞,一般,*,*,*,*,知識,チシキ,チシキ
層	名詞,接尾,一般,*,*,*,層,ソウ,ソー
通用	名詞,サ変接続,*,*,*,*,通用,ツウヨウ,ツーヨー
マカーマ	名詞,一般,*,*,*,*,*
マカーマート	名詞,一般,*,*,*,*,*
平凡社	名詞,固有名詞,組織,*,*,*,平凡社,ヘイボンシャ,ヘイボンシャ
東洋文庫	名詞,固有名詞,組織,*,*,*,東洋文庫,トウヨウブンコ,トーヨーブンコ
巻	名詞,接尾,助数詞,*,*,*,巻,カン,カン
〉	記号,括弧閉,*,*,*,*,〉,〉,〉
書き言葉	名詞,一般,*,*,*,*,書き言葉,カキコトバ,カキコトバ
とくに	副詞,一般,*,*,*,*,とくに,トクニ,トクニ
衰退	名詞,サ変接続,*,*,*,*,衰退,スイタイ,スイタイ
話し言葉	名詞,一般,*,*,*,*,話し言葉,ハナシコトバ,ハナシコトバ
続け	動詞,自立,*,*,一段,連用形,続ける,ツヅケ,ツズケ
より	副詞,一般,*,*,*,*,より,ヨリ,ヨリ
練り直さ	動詞,自立,*,*,五段・サ行,未然形,練り直す,ネリナオサ,ネリナオサ
新語	名詞,一般,*,*,*,*,新語,シンゴ,シンゴ
大量	名詞,形容動詞語幹,*,*,*,*,大量,タイリョウ,タイリョー
こうして	接続詞,*,*,*,*,*,こうして,コウシテ,コーシテ
面	名詞,一般,*,*,*,*,面,メン,メン
学術	名詞,一般,*,*,*,*,学術,ガクジュツ,ガクジュツ
雑誌	名詞,一般,*,*,*,*,雑誌,ザッシ,ザッシ
新聞	名詞,一般,*,*,*,*,新聞,シンブン,シンブン
文章	名詞,一般,*,*,*,*,文章,ブンショウ,ブンショー
もちろん	副詞,一般,*,*,*,*,もちろん,モチロン,モチロン
場	名詞,一般,*,*,*,*,場,バ,バ
会話	名詞,サ変接続,*,*,*,*,会話,カイワ,カイワ
改まっ	動詞,自立,*,*,五段・ラ行,連用タ接続,改まる,アラタマッ,アラタマッ
逆	名詞,一般,*,*,*,*,逆,ギャク,ギャク
言え	動詞,自立,*,*,五段・ワ行促音便,仮定形,言う,イエ,イエ
フスハー	名詞,固有名詞,一般,*,*,*,*
習う	動詞,自立,*,*,五段・ワ行促音便,基本形,習う,ナラウ,ナラウ
あくまでも	副詞,一般,*,*,*,*,あくまでも,アクマデモ,アクマデモ
変種	名詞,一般,*,*,*,*,変種,ヘンシュ,ヘンシュ
ラハジャ	名詞,一般,*,*,*,*,*
正字	名詞,一般,*,*,*,*,正字,セイジ,セイジ
無い	形容詞,自立,*,*,形容詞・アウオ段,基本形,無い,ナイ,ナイ
私信	名詞,一般,*,*,*,*,私信,シシン,シシン
大衆	名詞,一般,*,*,*,*,大衆,タイシュウ,タイシュー
演劇	名詞,一般,*,*,*,*,演劇,エンゲキ,エンゲキ
詩歌	名詞,一般,*,*,*,*,詩歌,シカ,シカ
ハッサニヤ	名詞,一般,*,*,*,*,*
大別	名詞,サ変接続,*,*,*,*,大別,タイベツ,タイベツ
なか	名詞,非自立,副詞可能,*,*,*,なか,ナカ,ナカ
宗派	名詞,一般,*,*,*,*,宗派,シュウハ,シューハ
差異	名詞,一般,*,*,*,*,差異,サイ,サイ
形態	名詞,一般,*,*,*,*,形態,ケイタイ,ケイタイ
遊牧民	名詞,一般,*,*,*,*,遊牧民,ユウボクミン,ユーボクミン
農村	名詞,一般,*,*,*,*,農村,ノウソン,ノーソン
分け	動詞,自立,*,*,一段,未然形,分ける,ワケ,ワケ
後者	名詞,一般,*,*,*,*,後者,コウシャ,コーシャ
派生	名詞,サ変接続,*,*,*,*,派生,ハセイ,ハセイ
死語	名詞,一般,*,*,*,*,死語,シゴ,シゴ
まれ	名詞,形容動詞語幹,*,*,*,*,まれ,マレ,マレ
使い分け	名詞,一般,*,*,*,*,使い分け,ツカイワケ,ツカイワケ
典型	名詞,一般,*,*,*,*,典型,テンケイ,テンケイ
マスメディア	名詞,一般,*,*,*,*,マスメディア,マスメディア,マスメディア
理解	名詞,サ変接続,*,*,*,*,理解,リカイ,リカイ
同士	名詞,一般,*,*,*,*,同士,ドウシ,ドーシ
支障	名詞,一般,*,*,*,*,支障,シショウ,シショー
出る	動詞,自立,*,*,一段,基本形,出る,デル,デル
皆無	名詞,形容動詞語幹,*,*,*,*,皆無,カイム,カイム
読み書き	名詞,サ変接続,*,*,*,*,読み書き,ヨミカキ,ヨミカキ
演説	名詞,サ変接続,*,*,*,*,演説,エンゼツ,エンゼツ
報道	名詞,サ変接続,*,*,*,*,報道,ホウドウ,ホードー
番組	名詞,一般,*,*,*,*,番組,バングミ,バングミ
従って	接続詞,*,*,*,*,*,従って,シタガッテ,シタガッテ
ネイティヴ	名詞,一般,*,*,*,*,*
現地	名詞,一般,*,*,*,*,現地,ゲンチ,ゲンチ
スムーズ	名詞,形容動詞語幹,*,*,*,*,スムーズ,スムーズ,スムーズ
当地	名詞,一般,*,*,*,*,当地,トウチ,トーチ
習得	名詞,サ変接続,*,*,*,*,習得,シュウトク,シュートク
単語	名詞,一般,*,*,*,*,単語,タンゴ,タンゴ
三つ	名詞,一般,*,*,*,*,三つ,ミッツ,ミッツ
子音	名詞,一般,*,*,*,*,子音,シイン,シイン
語根	名詞,一般,*,*,*,*,語根,ゴコン,ゴコン
分析	名詞,サ変接続,*,*,*,*,分析,ブンセキ,ブンセキ
そこ	名詞,代名詞,一般,*,*,*,そこ,ソコ,ソコ
母音	名詞,一般,*,*,*,*,母音,ボイン,ボイン
接頭	名詞,サ変接続,*,*,*,*,接頭,セットウ,セットー
辞	名詞,一般,*,*,*,*,辞,ジ,ジ
接尾	名詞,サ変接続,*,*,*,*,接尾,セツビ,セツビ
接	名詞,サ変接続,*,*,*,*,接,セッ,セッ
付け	動詞,自立,*,*,一段,連用形,付ける,ツケ,ツケ
たり	助詞,並立助詞,*,*,*,*,たり,タリ,タリ
活用	名詞,サ変接続,*,*,*,*,活用,カツヨウ,カツヨー
屈折	名詞,サ変接続,*,*,*,*,屈折,クッセツ,クッセツ
正書法	名詞,一般,*,*,*,*,正書法,セイショホウ,セイショホー
左右	名詞,サ変接続,*,*,*,*,左右,サユウ,サユー
繋がっ	動詞,自立,*,*,五段・ラ行,連用タ接続,繋がる,ツナガッ,ツナガッ
いく	動詞,非自立,*,*,五段・カ行促音便,基本形,いく,イク,イク
例外	名詞,一般,*,*,*,*,例外,レイガイ,レイガイ
右	名詞,一般,*,*,*,*,右,ミギ,ミギ
左	名詞,一般,*,*,*,*,左,ヒダリ,ヒダリ
読む	動詞,自立,*,*,五段・マ行,基本形,読む,ヨム,ヨム
数字	名詞,一般,*,*,*,*,数字,スウジ,スージ
綴ら	動詞,自立,*,*,五段・ラ行,未然形,綴る,ツヅラ,ツズラ
書体	名詞,一般,*,*,*,*,書体,ショタイ,ショタイ
書法	名詞,一般,*,*,*,*,書法,ショホウ,ショホー
もっぱら	副詞,一般,*,*,*,*,もっぱら,モッパラ,モッパラ
アルファベット	名詞,一般,*,*,*,*,アルファベット,アルファベット,アルファベット
大文字	名詞,一般,*,*,*,*,大文字,ダイモンジ,ダイモンジ
小文字	名詞,一般,*,*,*,*,小文字,コモジ,コモジ
区別	名詞,サ変接続,*,*,*,*,区別,クベツ,クベツ
綴り	名詞,一般,*,*,*,*,綴り,ツヅリ,ツズリ
字	名詞,一般,*,*,*,*,字,ジ,ジ
用いる	動詞,自立,*,*,一段,基本形,用いる,モチイル,モチイル
側	名詞,非自立,一般,*,*,*,側,ガワ,ガワ
補っ	動詞,自立,*,*,五段・ワ行促音便,連用タ接続,補う,オギナッ,オギナッ
読ま	動詞,自立,*,*,五段・マ行,未然形,読む,ヨマ,ヨマ
子供	名詞,一般,*,*,*,*,子供,コドモ,コドモ
読み物	名詞,一般,*,*,*,*,読み物,ヨミモノ,ヨミモノ
正確	名詞,形容動詞語幹,*,*,*,*,正確,セイカク,セイカク
符号	名詞,一般,*,*,*,*,符号,フゴウ,フゴー
シャクル	名詞,一般,*,*,*,*,*
付記	名詞,サ変接続,*,*,*,*,付記,フキ,フキ
書道	名詞,一般,*,*,*,*,書道,ショドウ,ショドー
兼ね	動詞,自立,*,*,一段,連用形,兼ねる,カネ,カネ
成人	名詞,サ変接続,*,*,*,*,成人,セイジン,セイジン
自著	名詞,一般,*,*,*,*,自著,ジチョ,ジチョ
喉	名詞,一般,*,*,*,*,喉,ノド,ノド
奥	名詞,一般,*,*,*,*,奥,オク,オク
ほう	名詞,非自立,一般,*,*,*,ほう,ホウ,ホー
独特	名詞,形容動詞語幹,*,*,*,*,独特,ドクトク,ドクトク
短	接頭詞,名詞接続,*,*,*,*,短,タン,タン
長	名詞,接尾,一般,*,*,*,長,チョウ,チョー
重母音	名詞,一般,*,*,*,*,重母音,ジュウボイン,ジューボイン
弁別	名詞,サ変接続,*,*,*,*,弁別,ベンベツ,ベンベツ
曜日	名詞,一般,*,*,*,*,曜日,ヨウビ,ヨービ
定冠詞	名詞,一般,*,*,*,*,定冠詞,テイカンシ,テイカンシ
前置詞	名詞,一般,*,*,*,*,前置詞,ゼンチシ,ゼンチシ
名詞	名詞,一般,*,*,*,*,名詞,メイシ,メイシ
形容詞	名詞,一般,*,*,*,*,形容詞,ケイヨウシ,ケイヨーシ
格	名詞,一般,*,*,*,*,格,カク,カク
主格	名詞,一般,*,*,*,*,主格,シュカク,シュカク
格	名詞,接尾,一般,*,*,*,格,カク,カク
対格	名詞,一般,*,*,*,*,対格,タイカク,タイカク
男性	名詞,一般,*,*,*,*,男性,ダンセイ,ダンセイ
数	名詞,一般,*,*,*,*,数,カズ,カズ
単数	名詞,一般,*,*,*,*,単数,タンスウ,タンスー
双	名詞,一般,*,*,*,*,双,ソウ,ソー
もとり	動詞,自立,*,*,五段・ラ行,連用形,もとる,モトリ,モトリ
無数	名詞,形容動詞語幹,*,*,*,*,無数,ムスウ,ムスー
例えば	接続詞,*,*,*,*,*,例えば,タトエバ,タトエバ
مُدَرِّسٌ	記号,一般,*,*,*,*,*
先生	名詞,一般,*,*,*,*,先生,センセイ,センセイ
語尾	名詞,一般,*,*,*,*,語尾,ゴビ,ゴビ
مُدَرِّسُونَ	記号,一般,*,*,*,*,*
صَدِيقٌ	記号,一般,*,*,*,*,*
友人	名詞,一般,*,*,*,*,友人,ユウジン,ユージン
不規則	名詞,形容動詞語幹,*,*,*,*,不規則,フキソク,フキソク
صَدِيقُونَ	記号,一般,*,*,*,*,*
أَصْدِقَاءُ	記号,一般,*,*,*,*,*
動詞	名詞,一般,*,*,*,*,動詞,ドウシ,ドーシ
人称	名詞,一般,*,*,*,*,人称,ニンショウ,ニンショー
完了	名詞,サ変接続,*,*,*,*,完了,カンリョウ,カンリョー
原形	名詞,一般,*,*,*,*,原形,ゲンケイ,ゲンケイ
配列	名詞,サ変接続,*,*,*,*,配列,ハイレツ,ハイレツ
辞典	名詞,一般,*,*,*,*,辞典,ジテン,ジテン
引く	動詞,自立,*,*,五段・カ行イ音便,基本形,引く,ヒク,ヒク
原型	名詞,一般,*,*,*,*,原型,ゲンケイ,ゲンケイ
十	名詞,数,*,*,*,*,十,ジュウ,ジュー
九	名詞,数,*,*,*,*,九,キュウ,キュー
人体	名詞,一般,*,*,*,*,人体,ジンタイ,ジンタイ
ハンス・ヴェーア	名詞,一般,*,*,*,*,*
語	名詞,一般,*,*,*,*,語,カタリ,カタリ
すなわち	接続詞,*,*,*,*,*,すなわち,スナワチ,スナワチ
抽出	名詞,サ変接続,*,*,*,*,抽出,チュウシュツ,チューシュツ
初	接頭詞,名詞接続,*,*,*,*,初,ハツ,ハツ
引き	名詞,接尾,一般,*,*,*,引き,ビキ,ビキ
困難	名詞,形容動詞語幹,*,*,*,*,困難,コンナン,コンナン
アル・アンダルス	名詞,一般,*,*,*,*,*
バハルナ・アラビア	名詞,一般,*,*,*,*,*
メソポタミア	名詞,固有名詞,地域,一般,*,*,メソポタミア,メソポタミア,メソポタミア
タイズィ	名詞,一般,*,*,*,*,*
アデン	名詞,固有名詞,地域,一般,*,*,アデン,アデン,アデン
ヒジャーズ・アラビア	名詞,一般,*,*,*,*,*
ゾファール・アラビア	名詞,一般,*,*,*,*,*
サイード・アラビア	名詞,一般,*,*,*,*,*
レヴァント	名詞,一般,*,*,*,*,*
エジプト・ベダウィ	名詞,一般,*,*,*,*,*
ナジュド・アラビア	名詞,一般,*,*,*,*,*
ハドラミ・アラビア	名詞,一般,*,*,*,*,*
サヌア	名詞,固有名詞,地域,一般,*,*,サヌア,サヌア,サヌア
ハッサーニーヤ	名詞,一般,*,*,*,*,*
シュワー・アラビア	名詞,一般,*,*,*,*,*
〕	記号,括弧閉,*,*,*,*,〕,〕,〕
シヒ・アラビア	名詞,一般,*,*,*,*,*
シークロ・アラビア	名詞,一般,*,*,*,*,*
トリポリタニア・アラビア	名詞,一般,*,*,*,*,*
薄い	形容詞,自立,*,*,形容詞・アウオ段,基本形,薄い,ウスイ,ウスイ
ハシミテ	名詞,一般,*,*,*,*,*
たとえば	接続詞,*,*,*,*,*,たとえば,タトエバ,タトエバ
マロン	名詞,一般,*,*,*,*,マロン,マロン,マロン
キリスト教徒	名詞,一般,*,*,*,*,キリスト教徒,キリストキョウト,キリストキョート
話す	動詞,自立,*,*,五段・サ行,基本形,話す,ハナス,ハナス
カビール	名詞,一般,*,*,*,*,*
ベルベル	名詞,一般,*,*,*,*,*
宗主	名詞,一般,*,*,*,*,宗主,ソウシュ,ソーシュ
国語	名詞,一般,*,*,*,*,国語,コクゴ,コクゴ
通じる	動詞,自立,*,*,一段,基本形,通じる,ツウジル,ツージル
上	名詞,非自立,副詞可能,*,*,*,上,ウエ,ウエ
かなり	名詞,一般,*,*,*,*,かなり,カナリ,カナリ
隣国	名詞,一般,*,*,*,*,隣国,リンゴク,リンゴク
争っ	動詞,自立,*,*,五段・ワ行促音便,連用タ接続,争う,アラソッ,アラソッ
と共に	助詞,格助詞,連語,*,*,*,と共に,トトモニ,トトモニ
黒人	名詞,一般,*,*,*,*,黒人,コクジン,コクジン
フール	名詞,一般,*,*,*,*,*
紛争	名詞,サ変接続,*,*,*,*,紛争,フンソウ,フンソー
絶え	動詞,自立,*,*,一段,未然形,絶える,タエ,タエ
に対し	助詞,格助詞,連語,*,*,*,に対し,ニタイシ,ニタイシ
アファル	名詞,一般,*,*,*,*,*
イッサ	名詞,一般,*,*,*,*,*
典礼	名詞,一般,*,*,*,*,典礼,テンレイ,テンレイ
明確	名詞,形容動詞語幹,*,*,*,*,明確,メイカク,メイカク
対比	名詞,サ変接続,*,*,*,*,対比,タイヒ,タイヒ
切り替え	名詞,一般,*,*,*,*,切り替え,キリカエ,キリカエ
深度	名詞,一般,*,*,*,*,深度,シンド,シンド
速度	名詞,一般,*,*,*,*,速度,ソクド,ソクド
積極	名詞,形容動詞語幹,*,*,*,*,積極,セッキョク,セッキョク
目立っ	動詞,自立,*,*,五段・タ行,連用タ接続,目立つ,メダッ,メダッ
課程	名詞,一般,*,*,*,*,課程,カテイ,カテイ
官僚	名詞,一般,*,*,*,*,官僚,カンリョウ,カンリョー
占有	名詞,サ変接続,*,*,*,*,占有,センユウ,センユー
打破	名詞,サ変接続,*,*,*,*,打破,ダハ,ダハ
エリート	名詞,一般,*,*,*,*,エリート,エリート,エリート
まま	名詞,非自立,副詞可能,*,*,*,まま,ママ,ママ
階層	名詞,一般,*,*,*,*,階層,カイソウ,カイソー
対立	名詞,サ変接続,*,*,*,*,対立,タイリツ,タイリツ
生じ	動詞,自立,*,*,一段,連用形,生じる,ショウジ,ショージ
結びつい	動詞,自立,*,*,五段・カ行イ音便,連用タ接続,結びつく,ムスビツイ,ムスビツイ
招き	動詞,自立,*,*,五段・カ行イ音便,連用形,招く,マネキ,マネキ
つながっ	動詞,自立,*,*,五段・ラ行,連用タ接続,つながる,ツナガッ,ツナガッ
語口	名詞,一般,*,*,*,*,語口,カタリクチ,カタリクチ
借用	名詞,サ変接続,*,*,*,*,借用,シャクヨウ,シャクヨー
委任	名詞,サ変接続,*,*,*,*,委任,イニン,イニン
英国	名詞,固有名詞,地域,国,*,*,英国,エイコク,エイコク
児童	名詞,一般,*,*,*,*,児童,ジドウ,ジドー
生徒	名詞,一般,*,*,*,*,生徒,セイト,セイト
中等	名詞,一般,*,*,*,*,中等,チュウトウ,チュートー
割り当て	動詞,自立,*,*,一段,未然形,割り当てる,ワリアテ,ワリアテ
雇用	名詞,サ変接続,*,*,*,*,雇用,コヨウ,コヨー
話せる	動詞,自立,*,*,一段,基本形,話せる,ハナセル,ハナセル
課さ	動詞,自立,*,*,五段・サ行,未然形,課す,カサ,カサ
全く	副詞,助詞類接続,*,*,*,*,全く,マッタク,マッタク
視	名詞,接尾,サ変接続,*,*,*,視,シ,シ
故	接頭詞,名詞接続,*,*,*,*,故,コ,コ
切手	名詞,一般,*,*,*,*,切手,キッテ,キッテ
ベンヤミン・ネタニヤフ	名詞,一般,*,*,*,*,*
外し	動詞,自立,*,*,五段・サ行,連用形,外す,ハズシ,ハズシ
格下げ	名詞,サ変接続,*,*,*,*,格下げ,カクサゲ,カクサゲ
閣議	名詞,一般,*,*,*,*,閣議,カクギ,カクギ
反発	名詞,サ変接続,*,*,*,*,反発,ハンパツ,ハンパツ
起こっ	動詞,自立,*,*,五段・ラ行,連用タ接続,起こる,オコッ,オコッ
扱わ	動詞,自立,*,*,五段・ワ行促音便,未然形,扱う,アツカワ,アツカワ
必ず	副詞,助詞類接続,*,*,*,*,必ず,カナラズ,カナラズ
唱える	動詞,自立,*,*,一段,基本形,唱える,トナエル,トナエル
内容	名詞,一般,*,*,*,*,内容,ナイヨウ,ナイヨー
必ずしも	副詞,一般,*,*,*,*,必ずしも,カナラズシモ,カナラズシモ
不可欠	名詞,形容動詞語幹,*,*,*,*,不可欠,フカケツ,フカケツ
信徒	名詞,一般,*,*,*,*,信徒,シント,シント
薄く	形容詞,自立,*,*,形容詞・アウオ段,連用テ接続,薄い,ウスク,ウスク
ハタイ	名詞,一般,*,*,*,*,*
マル	名詞,一般,*,*,*,*,マル,マル,マル
ディン	名詞,固有名詞,人名,名,*,*,ディン,ディン,ディン
スィイルト	名詞,一般,*,*,*,*,*
シャンルウルファ	名詞,一般,*,*,*,*,*
フーゼスターン	名詞,固有名詞,地域,一般,*,*,*
住み	動詞,自立,*,*,五段・マ行,連用形,住む,スミ,スミ
集	名詞,一般,*,*,*,*,集,シュウ,シュー
住	名詞,一般,*,*,*,*,住,ジュウ,ジュー
なかでも	副詞,一般,*,*,*,*,なかでも,ナカデモ,ナカデモ
広まっ	動詞,自立,*,*,五段・ラ行,連用タ接続,広まる,ヒロマッ,ヒロマッ
一大	名詞,一般,*,*,*,*,一大,イチダイ,イチダイ
保っ	動詞,自立,*,*,五段・タ行,連用タ接続,保つ,タモッ,タモッ
語句	名詞,一般,*,*,*,*,語句,ゴク,ゴク
トタン	名詞,一般,*,*,*,*,トタン,トタン,トタン
じょうろ	名詞,一般,*,*,*,*,じょうろ,ジョウロ,ジョーロ
ラケット	名詞,一般,*,*,*,*,ラケット,ラケット,ラケット
シロップ	名詞,一般,*,*,*,*,シロップ,シロップ,シロップ
アルコール	名詞,一般,*,*,*,*,アルコール,アルコール,アルコール
アルカリ	名詞,一般,*,*,*,*,アルカリ,アルカリ,アルカリ
ソーダ	名詞,一般,*,*,*,*,ソーダ,ソーダ,ソーダ
シャーベット	名詞,一般,*,*,*,*,シャーベット,シャーベット,シャーベット
チェス	名詞,一般,*,*,*,*,チェス,チェス,チェス
チェック	名詞,サ変接続,*,*,*,*,チェック,チェック,チェック
小切手	名詞,一般,*,*,*,*,小切手,コギッテ,コギッテ
ソファー	名詞,一般,*,*,*,*,ソファー,ソファー,ソファー
モンスーン	名詞,一般,*,*,*,*,モンスーン,モンスーン,モンスーン
アベレージ	名詞,一般,*,*,*,*,アベレージ,アベレージ,アベレージ
値	名詞,接尾,一般,*,*,*,値,チ,チ
ジャケット	名詞,一般,*,*,*,*,ジャケット,ジャケット,ジャケット
ゼロ	名詞,数,*,*,*,*,ゼロ,ゼロ,ゼロ
零	名詞,数,*,*,*,*,零,レイ,レイ
タリフ	名詞,一般,*,*,*,*,*
関税	名詞,一般,*,*,*,*,関税,カンゼイ,カンゼイ
アルゴリズム	名詞,一般,*,*,*,*,アルゴリズム,アルゴリズム,アルゴリズム
アドベ	名詞,一般,*,*,*,*,*
タマリンド	名詞,一般,*,*,*,*,*
コットン	名詞,一般,*,*,*,*,コットン,コットン,コットン
サフラン	名詞,一般,*,*,*,*,サフラン,サフラン,サフラン
大将	名詞,一般,*,*,*,*,大将,タイショウ,タイショー
アドミラル	名詞,一般,*,*,*,*,*
センナ	名詞,一般,*,*,*,*,*
シュガー	名詞,一般,*,*,*,*,シュガー,シュガー,シュガー
砂糖	名詞,一般,*,*,*,*,砂糖,サトウ,サトー
ラクダ	名詞,一般,*,*,*,*,ラクダ,ラクダ,ラクダ
キャメル	名詞,一般,*,*,*,*,*
カラット	名詞,一般,*,*,*,*,カラット,カラット,カラット
ガーゼ	名詞,一般,*,*,*,*,ガーゼ,ガーゼ,ガーゼ
カンフル	名詞,一般,*,*,*,*,カンフル,カンフル,カンフル
樟脳	名詞,一般,*,*,*,*,樟脳,ショウノウ,ショーノー
ギプス	名詞,一般,*,*,*,*,ギプス,ギプス,ギプス
とりわけ	副詞,一般,*,*,*,*,とりわけ,トリワケ,トリワケ
取り入れ	動詞,自立,*,*,一段,連用形,取り入れる,トリイレ,トリイレ
星	名詞,接尾,一般,*,*,*,星,ボシ,ボシ
アルタイル	名詞,一般,*,*,*,*,*
飛ぶ	動詞,自立,*,*,五段・バ行,基本形,飛ぶ,トブ,トブ
鷲	名詞,一般,*,*,*,*,鷲,ワシ,ワシ
熟語	名詞,一般,*,*,*,*,熟語,ジュクゴ,ジュクゴ
単独	名詞,一般,*,*,*,*,単独,タンドク,タンドク
鳥	名詞,一般,*,*,*,*,鳥,トリ,トリ
アルデバラン	名詞,一般,*,*,*,*,*
従う	動詞,自立,*,*,五段・ワ行促音便,基本形,従う,シタガウ,シタガウ
プレアデス	名詞,一般,*,*,*,*,*
星団	名詞,一般,*,*,*,*,星団,セイダン,セイダン
地平線	名詞,一般,*,*,*,*,地平線,チヘイセン,チヘイセン
昇る	動詞,自立,*,*,五段・ラ行,基本形,昇る,ノボル,ノボル
アルゴル	名詞,一般,*,*,*,*,*
グール	名詞,一般,*,*,*,*,*
頭	名詞,一般,*,*,*,*,頭,アタマ,アタマ
アルビレオ	名詞,一般,*,*,*,*,*
雌鳥	名詞,一般,*,*,*,*,雌鳥,メンドリ,メンドリ
くちばし	名詞,一般,*,*,*,*,くちばし,クチバシ,クチバシ
誤訳	名詞,サ変接続,*,*,*,*,誤訳,ゴヤク,ゴヤク
誤解	名詞,サ変接続,*,*,*,*,誤解,ゴカイ,ゴカイ
経	動詞,自立,*,*,一段,連用形,経る,ヘ,ヘ
ベガ	名詞,一般,*,*,*,*,*
ヴェガ	名詞,一般,*,*,*,*,*
降り立つ	動詞,自立,*,*,五段・タ行,基本形,降り立つ,オリタツ,オリタツ
降り	動詞,自立,*,*,一段,連用形,降りる,オリ,オリ
立つ	動詞,自立,*,*,五段・タ行,基本形,立つ,タツ,タツ
デ	助詞,格助詞,一般,*,*,*,デ,デ,デ
ネブ	名詞,一般,*,*,*,*,ネブ,ネブ,ネブ
鶏	名詞,一般,*,*,*,*,鶏,ニワトリ,ニワトリ
尾	名詞,一般,*,*,*,*,尾,オ,オ
フォーマルハウト	名詞,一般,*,*,*,*,*
口	名詞,一般,*,*,*,*,口,クチ,クチ
ベテルギウス	名詞,一般,*,*,*,*,*
巨人	名詞,固有名詞,組織,*,*,*,巨人,キョジン,キョジン
腋の下	名詞,一般,*,*,*,*,腋の下,ワキノシタ,ワキノシタ
リゲル	名詞,一般,*,*,*,*,*
脚	名詞,一般,*,*,*,*,脚,アシ,アシ
酸	名詞,一般,*,*,*,*,酸,サン,サン
アシッド	名詞,一般,*,*,*,*,*
始まる	動詞,自立,*,*,五段・ラ行,基本形,始まる,ハジマル,ハジマル
冠詞	名詞,一般,*,*,*,*,冠詞,カンシ,カンシ
語法	名詞,一般,*,*,*,*,語法,ゴホウ,ゴホー
導入	名詞,サ変接続,*,*,*,*,導入,ドウニュウ,ドーニュー
改め	動詞,自立,*,*,一段,未然形,改める,アラタメ,アラタメ
商人	名詞,一般,*,*,*,*,商人,ショウニン,ショーニン
訪れ	動詞,自立,*,*,一段,連用形,訪れる,オトズレ,オトズレ
バントゥー	名詞,一般,*,*,*,*,*
語幹	名詞,一般,*,*,*,*,語幹,ゴカン,ゴカン
商業	名詞,一般,*,*,*,*,商業,ショウギョウ,ショーギョー
テュルク	名詞,一般,*,*,*,*,*
ヒンドゥスターニー	名詞,一般,*,*,*,*,*
伝播	名詞,サ変接続,*,*,*,*,伝播,デンパ,デンパ
ダマスカス	名詞,固有名詞,地域,一般,*,*,ダマスカス,ダマスカス,ダマスカス
創立	名詞,サ変接続,*,*,*,*,創立,ソウリツ,ソーリツ
カイロ	名詞,固有名詞,地域,一般,*,*,カイロ,カイロ,カイロ
担っ	動詞,自立,*,*,五段・ワ行促音便,連用タ接続,担う,ニナッ,ニナッ
できるだけ	副詞,一般,*,*,*,*,できるだけ,デキルダケ,デキルダケ
制限	名詞,サ変接続,*,*,*,*,制限,セイゲン,セイゲン
解釈	名詞,サ変接続,*,*,*,*,解釈,カイシャク,カイシャク
タフスィール	名詞,一般,*,*,*,*,*
学説	名詞,一般,*,*,*,*,学説,ガクセツ,ガクセツ
ハムザ	名詞,一般,*,*,*,*,*
ことば	名詞,一般,*,*,*,*,ことば,コトバ,コトバ
佐藤	名詞,固有名詞,人名,姓,*,*,佐藤,サトウ,サトー
岡田	名詞,固有名詞,人名,姓,*,*,岡田,オカダ,オカダ
恵美子	名詞,固有名詞,人名,名,*,*,恵美子,エミコ,エミコ
編著	名詞,一般,*,*,*,*,編著,ヘンチョ,ヘンチョ
早稲田大学	名詞,固有名詞,組織,*,*,*,早稲田大学,ワセダダイガク,ワセダダイガク
成文	名詞,一般,*,*,*,*,成文,セイブン,セイブン
初版	名詞,一般,*,*,*,*,初版,ショハン,ショハン
刷	名詞,接尾,助数詞,*,*,*,刷,サツ,サツ
章	名詞,接尾,助数詞,*,*,*,章,ショウ,ショー
私市	名詞,固有名詞,地域,一般,*,*,私市,キサイチ,キサイチ
正	名詞,一般,*,*,*,*,正,セイ,セイ
明石書店	名詞,固有名詞,組織,*,*,*,明石書店,アカシショテン,アカシショテン
ケース・フェルステーヘ	名詞,固有名詞,一般,*,*,*,*
長渡	名詞,固有名詞,地域,一般,*,*,長渡,ナガワタリ,ナガワタリ
陽	名詞,一般,*,*,*,*,陽,ヒ,ヒ
三省堂	名詞,固有名詞,組織,*,*,*,三省堂,サンセイドウ,サンセイドー
立山	名詞,固有名詞,地域,一般,*,*,立山,タテヤマ,タテヤマ
良司	名詞,固有名詞,人名,名,*,*,良司,リョウジ,リョージ
外す	動詞,自立,*,*,五段・サ行,基本形,外す,ハズス,ハズス
久美子	名詞,固有名詞,人名,名,*,*,久美子,クミコ,クミコ
圭一	名詞,固有名詞,人名,名,*,*,圭一,ケイイチ,ケイイチ
珠	名詞,一般,*,*,*,*,珠,タマ,タマ
里	名詞,一般,*,*,*,*,里,サト,サト
広報	名詞,サ変接続,*,*,*,*,広報,コウホウ,コーホー
入門	名詞,サ変接続,*,*,*,*,入門,ニュウモン,ニューモン
黒柳	名詞,固有名詞,人名,姓,*,*,黒柳,クロヤナギ,クロヤナギ
恒男	名詞,固有名詞,人名,名,*,*,恒男,ツネオ,ツネオ
飯森	名詞,固有名詞,人名,姓,*,*,飯森,イイモリ,イーモリ
嘉助	名詞,固有名詞,人名,名,*,*,嘉助,カスケ,カスケ
書林	名詞,一般,*,*,*,*,書林,ショリン,ショリン
池田	名詞,固有名詞,人名,姓,*,*,池田,イケダ,イケダ
修	名詞,固有名詞,人名,名,*,*,修,オサム,オサム
絶版	名詞,サ変接続,*,*,*,*,絶版,ゼッパン,ゼッパン
ネイティブ	名詞,一般,*,*,*,*,ネイティブ,ネイティブ,ネイティブ
スピーカー	名詞,一般,*,*,*,*,スピーカー,スピーカー,スピーカー
東京外国語大学	名詞,固有名詞,組織,*,*,*,東京外国語大学,トウキョウガイコクゴダイガク,トーキョーガイコクゴダイガク
専攻	名詞,サ変接続,*,*,*,*,専攻,センコウ,センコー
ホームページ	名詞,一般,*,*,*,*,ホームページ,ホームページ,ホームページ
法人	名詞,一般,*,*,*,*,法人,ホウジン,ホージン
検定	名詞,サ変接続,*,*,*,*,検定,ケンテイ,ケンテイ
ちゃん	名詞,接尾,人名,*,*,*,ちゃん,チャン,チャン
ねる	動詞,自立,*,*,一段,基本形,ねる,ネル,ネル
了解	名詞,サ変接続,*,*,*,*,了解,リョウカイ,リョーカイ
マックス・プランク	名詞,一般,*,*,*,*,*
進化	名詞,サ変接続,*,*,*,*,進化,シンカ,シンカ
データーベース	名詞,固有名詞,一般,*,*,*,*
概説	名詞,サ変接続,*,*,*,*,概説,ガイセツ,ガイセツ
小児	名詞,一般,*,*,*,*,小児,ショウニ,ショーニ
経	名詞,一般,*,*,*,*,経,ケイ,ケイ
ペ	名詞,一般,*,*,*,*,ペ,ペ,ペ
ルシア	名詞,固有名詞,人名,名,*,*,ルシア,ルシア,ルシア
シャームキー	名詞,一般,*,*,*,*,*
ジャウィ	名詞,一般,*,*,*,*,*
ジャーウィー	名詞,一般,*,*,*,*,*
ا	記号,一般,*,*,*,*,*
ب	記号,一般,*,*,*,*,*
ت	記号,一般,*,*,*,*,*
ث	記号,一般,*,*,*,*,*
ج	記号,一般,*,*,*,*,*
ح	記号,一般,*,*,*,*,*
خ	記号,一般,*,*,*,*,*
د	記号,一般,*,*,*,*,*
ذ	記号,一般,*,*,*,*,*
ر	記号,一般,*,*,*,*,*
ز	記号,一般,*,*,*,*,*
س	記号,一般,*,*,*,*,*
ش	記号,一般,*,*,*,*,*
ص	記号,一般,*,*,*,*,*
ض	記号,一般,*,*,*,*,*
ط	記号,一般,*,*,*,*,*
ظ	記号,一般,*,*,*,*,*
ع	記号,一般,*,*,*,*,*
غ	記号,一般,*,*,*,*,*
ف	記号,一般,*,*,*,*,*
ق	記号,一般,*,*,*,*,*
ك	記号,一般,*,*,*,*,*
ل	記号,一般,*,*,*,*,*
م	記号,一般,*,*,*,*,*
ن	記号,一般,*,*,*,*,*
ه	記号,一般,*,*,*,*,*
و	記号,一般,*,*,*,*,*
ي	記号,一般,*,*,*,*,*
ة	記号,一般,*,*,*,*,*
ء	記号,一般,*,*,*,*,*
クーフィー	名詞,一般,*,*,*,*,*
スィーニー	名詞,一般,*,*,*,*,*
スルス	名詞,一般,*,*,*,*,*
タアリーク	名詞,一般,*,*,*,*,*
ディーワーニ	名詞,一般,*,*,*,*,*
ナスタアリーク	名詞,一般,*,*,*,*,*
ナスフ	名詞,一般,*,*,*,*,*
ムハッカク	名詞,一般,*,*,*,*,*
ルクア	名詞,一般,*,*,*,*,*
数詞	名詞,一般,*,*,*,*,数詞,スウシ,スーシ
シャッダ	名詞,一般,*,*,*,*,*
ジジェル	名詞,一般,*,*,*,*,*
ジュバラ	名詞,一般,*,*,*,*,*
ハッサニア	名詞,一般,*,*,*,*,*
ド	接頭詞,名詞接続,*,*,*,*,ド,ド,ド
ファール	名詞,一般,*,*,*,*,ファール,ファール,ファール
バント	名詞,一般,*,*,*,*,バント,バント,バント
フーゼスターン	名詞,一般,*,*,*,*,*
斜	名詞,一般,*,*,*,*,斜,ハス,ハス
字体	名詞,一般,*,*,*,*,字体,ジタイ,ジタイ
キトゥバ	名詞,一般,*,*,*,*,*
カヌリ	名詞,一般,*,*,*,*,*
フラニ	名詞,一般,*,*,*,*,*
チェワ	名詞,一般,*,*,*,*,*
ティグリニャ	名詞,一般,*,*,*,*,*
モシ	名詞,一般,*,*,*,*,*
Араб	名詞,一般,*,*,*,*,*
бызшәа	名詞,一般,*,*,*,*,*
Арапыбзэ	名詞,一般,*,*,*,*,*
ዓረብኛ	記号,一般,*,*,*,*,*
ܠܫܢܐ	記号,一般,*,*,*,*,*
ܥܪܒܝܐ	記号,一般,*,*,*,*,*
لعربية	記号,一般,*,*,*,*,*
لغه	記号,一般,*,*,*,*,*
عربى	記号,一般,*,*,*,*,*
আৰবী	記号,一般,*,*,*,*,*
ভাষা	記号,一般,*,*,*,*,*
ГІараб	名詞,一般,*,*,*,*,*
мацІ	名詞,一般,*,*,*,*,*
अरबी	記号,一般,*,*,*,*,*
عرب	記号,一般,*,*,*,*,*
دیلی	記号,一般,*,*,*,*,*
Ғәрәп	名詞,一般,*,*,*,*,*
теле	名詞,一般,*,*,*,*,*
Арабская	名詞,一般,*,*,*,*,*
мова	名詞,一般,*,*,*,*,*
Арабски	名詞,一般,*,*,*,*,*
език	名詞,一般,*,*,*,*,*
バンジャル	名詞,一般,*,*,*,*,*
আরবি	記号,一般,*,*,*,*,*
ཨ་རབ་སྐད།	記号,一般,*,*,*,*,*
хэлэн	名詞,一般,*,*,*,*,*
Ā	名詞,一般,*,*,*,*,*
Ӏаьрбийн	名詞,一般,*,*,*,*,*
мотт	名詞,一般,*,*,*,*,*
ᎠᎸᎠᎳᏈᏯ	記号,一般,*,*,*,*,*
ᎦᏬᏂᎯᏍᏗ	記号,一般,*,*,*,*,*
زمانی	記号,一般,*,*,*,*,*
عەرەبی	記号,一般,*,*,*,*,*
Аравьскъ	名詞,一般,*,*,*,*,*
ѩ	名詞,一般,*,*,*,*,*
ꙁꙑ	記号,一般,*,*,*,*,*
къ	名詞,固有名詞,組織,*,*,*,*
Арап	名詞,一般,*,*,*,*,*
ч	名詞,一般,*,*,*,*,*
ĕ	名詞,一般,*,*,*,*,*
лхи	名詞,一般,*,*,*,*,*
ޢަރަބި	記号,一般,*,*,*,*,*
Αραβική	名詞,一般,*,*,*,*,*
γλώσσα	名詞,一般,*,*,*,*,*
زبان	記号,一般,*,*,*,*,*
عربی	記号,一般,*,*,*,*,*
阿	動詞,自立,*,*,五段・ラ行,体言接続特殊２,阿る,オモネ,オモネ
拉伯	名詞,一般,*,*,*,*,*
𐌰𐍂𐌰𐌱𐌹𐍃𐌺𐌰	記号,一般,*,*,*,*,*
𐍂𐌰𐌶𐌳𐌰	記号,一般,*,*,*,*,*
અરબી	記号,一般,*,*,*,*,*
ભાષા	記号,一般,*,*,*,*,*
Â	名詞,一般,*,*,*,*,*
ערבית	記号,一般,*,*,*,*,*
Արաբերեն	記号,一般,*,*,*,*,*
Արաբերէն	記号,一般,*,*,*,*,*
арбий	名詞,一般,*,*,*,*,*
ᐊᕋᕕ	記号,一般,*,*,*,*,*
არაბული	記号,一般,*,*,*,*,*
ენა	記号,一般,*,*,*,*,*
Хьэрыпыбзэ	名詞,一般,*,*,*,*,*
ɩɩ	記号,一般,*,*,*,*,*
ʊ	記号,一般,*,*,*,*,*
ŋ	名詞,固有名詞,組織,*,*,*,*
тілі	名詞,一般,*,*,*,*,*
ភាសាអារ៉ាប់	記号,一般,*,*,*,*,*
ಅರಬ್ಬೀ	記号,一般,*,*,*,*,*
ಭಾಷೆ	記号,一般,*,*,*,*,*
아랍어	記号,一般,*,*,*,*,*
кыв	名詞,一般,*,*,*,*,*
عَربی	記号,一般,*,*,*,*,*
زَبان	記号,一般,*,*,*,*,*
тили	名詞,一般,*,*,*,*,*
Аьраб	名詞,一般,*,*,*,*,*
маз	名詞,一般,*,*,*,*,*
ал	名詞,一般,*,*,*,*,*
ພາສາອາຣັບ	記号,一般,*,*,*,*,*
Арабонь	名詞,一般,*,*,*,*,*
кяль	名詞,一般,*,*,*,*,*
Арапски	名詞,一般,*,*,*,*,*
јазик	名詞,一般,*,*,*,*,*
അറബി	記号,一般,*,*,*,*,*
ഭാഷ	記号,一般,*,*,*,*,*
хэл	名詞,一般,*,*,*,*,*
ꯑꯔꯥꯕꯤꯛ	記号,一般,*,*,*,*,*
အာရပ်ဘာသာစကား	記号,一般,*,*,*,*,*
кель	名詞,一般,*,*,*,*,*
Араббаг	名詞,一般,*,*,*,*,*
æ	名詞,一般,*,*,*,*,*
взаг	名詞,一般,*,*,*,*,*
ਅਰਬੀ	記号,一般,*,*,*,*,*
ਭਾਸ਼ਾ	記号,一般,*,*,*,*,*
عربي	記号,一般,*,*,*,*,*
ژبه	記号,一般,*,*,*,*,*
Арабский	名詞,一般,*,*,*,*,*
язык	名詞,一般,*,*,*,*,*
Арабскый	名詞,一般,*,*,*,*,*
अरबीभाषा	記号,一般,*,*,*,*,*
Арааб	名詞,一般,*,*,*,*,*
ᱟᱨᱚᱵᱤᱠ	記号,一般,*,*,*,*,*
ᱯᱟᱹᱨᱥᱤ	記号,一般,*,*,*,*,*
ٻولي	記号,一般,*,*,*,*,*
අරාබි	記号,一般,*,*,*,*,*
භාෂාව	記号,一般,*,*,*,*,*
језик	名詞,一般,*,*,*,*,*
அரபு	記号,一般,*,*,*,*,*
மொழி	記号,一般,*,*,*,*,*
ಅರಬ್ಬಿ	記号,一般,*,*,*,*,*
ಬಾಸೆ	記号,一般,*,*,*,*,*
అరబ్బీ	記号,一般,*,*,*,*,*
భాష	記号,一般,*,*,*,*,*
Забони	名詞,一般,*,*,*,*,*
арабӣ	名詞,一般,*,*,*,*,*
ภาษาอาหรับ	記号,一般,*,*,*,*,*
Гарәп	名詞,一般,*,*,*,*,*
кыл	名詞,一般,*,*,*,*,*
ئەرەب	記号,一般,*,*,*,*,*
تىلى	記号,一般,*,*,*,*,*
Арабська	名詞,一般,*,*,*,*,*
Ả	名詞,一般,*,*,*,*,*
语	名詞,一般,*,*,*,*,*
Арабмудин	名詞,一般,*,*,*,*,*
келн	名詞,一般,*,*,*,*,*
ნინა	記号,一般,*,*,*,*,*
אראביש	記号,一般,*,*,*,*,*
中野	名詞,固有名詞,地域,一般,*,*,中野,ナカノ,ナカノ
本町	名詞,固有名詞,地域,一般,*,*,本町,ホンチョウ,ホンチョー
メトロ	名詞,一般,*,*,*,*,メトロ,メトロ,メトロ
中野新橋	名詞,固有名詞,一般,*,*,*,中野新橋,ナカノシンバシ,ナカノシンバシ
マンション	名詞,一般,*,*,*,*,マンション,マンション,マンション
軽食	名詞,サ変接続,*,*,*,*,軽食,ケイショク,ケイショク
宅配	名詞,サ変接続,*,*,*,*,宅配,タクハイ,タクハイ
テイクアウト	名詞,一般,*,*,*,*,*
イートイン	名詞,一般,*,*,*,*,*
深夜	名詞,副詞可能,*,*,*,*,深夜,シンヤ,シンヤ
雰囲気	名詞,一般,*,*,*,*,雰囲気,フンイキ,フンイキ
カジュアル	名詞,一般,*,*,*,*,カジュアル,カジュアル,カジュアル
カジュアル	名詞,形容動詞語幹,*,*,*,*,カジュアル,カジュアル,カジュアル
居心地	名詞,一般,*,*,*,*,居心地,イゴコチ,イゴコチ
良い	形容詞,自立,*,*,形容詞・アウオ段,基本形,良い,ヨイ,ヨイ
ケバブ	名詞,固有名詞,一般,*,*,*,*
 	記号,一般,*,*,*,*,*
ランプ	名詞,一般,*,*,*,*,ランプ,ランプ,ランプ
とても	副詞,助詞類接続,*,*,*,*,とても,トテモ,トテモ
楽しい	形容詞,自立,*,*,形容詞・イ段,基本形,楽しい,タノシイ,タノシイ
😊	記号,一般,*,*,*,*,*
立派	名詞,形容動詞語幹,*,*,*,*,立派,リッパ,リッパ
くれ	動詞,非自立,*,*,一段・クレル,連用形,くれる,クレ,クレ
ありがとう	感動詞,*,*,*,*,*,ありがとう,アリガトウ,アリガトー
ござい	助動詞,*,*,*,五段・ラ行特殊,連用形,ござる,ゴザイ,ゴザイ
ケバブカフェ	名詞,一般,*,*,*,*,*
エルトゥールル	名詞,一般,*,*,*,*,*
カフェ	名詞,一般,*,*,*,*,カフェ,カフェ,カフェ
喫茶	名詞,一般,*,*,*,*,喫茶,キッサ,キッサ
ケバブショップ	名詞,一般,*,*,*,*,*
チキンドネルケバブ	名詞,一般,*,*,*,*,*
ベジタリアン	名詞,一般,*,*,*,*,*
タイム	名詞,一般,*,*,*,*,タイム,タイム,タイム
ランチ	名詞,一般,*,*,*,*,ランチ,ランチ,ランチ
ディナー	名詞,一般,*,*,*,*,ディナー,ディナー,ディナー
デザート	名詞,一般,*,*,*,*,デザート,デザート,デザート
座席	名詞,一般,*,*,*,*,座席,ザセキ,ザセキ
設備	名詞,サ変接続,*,*,*,*,設備,セツビ,セツビ
トイレ	名詞,一般,*,*,*,*,トイレ,トイレ,トイレ
支払い	名詞,一般,*,*,*,*,支払い,シハライ,シハライ
百人	名詞,固有名詞,地域,一般,*,*,百人,ヒャクニン,ヒャクニン
手頃	名詞,一般,*,*,*,*,手頃,テゴロ,テゴロ
やや	副詞,一般,*,*,*,*,やや,ヤヤ,ヤヤ
ヒサル	名詞,一般,*,*,*,*,*
大久保	名詞,固有名詞,人名,姓,*,*,大久保,オオクボ,オークボ
ケバブ	名詞,一般,*,*,*,*,*
多彩	名詞,形容動詞語幹,*,*,*,*,多彩,タサイ,タサイ
創作	名詞,サ変接続,*,*,*,*,創作,ソウサク,ソーサク
楽しめる	動詞,自立,*,*,一段,基本形,楽しめる,タノシメル,タノシメル
定番	名詞,一般,*,*,*,*,定番,テイバン,テイバン
ドネルケバブ	名詞,一般,*,*,*,*,*
他	名詞,非自立,副詞可能,*,*,*,他,ホカ,ホカ
実	名詞,一般,*,*,*,*,実,ミ,ミ
レーズン	名詞,一般,*,*,*,*,レーズン,レーズン,レーズン
ピラフ	名詞,一般,*,*,*,*,ピラフ,ピラフ,ピラフ
詰め	動詞,自立,*,*,一段,連用形,詰める,ツメ,ツメ
ドルマ	名詞,一般,*,*,*,*,*
シェフ	名詞,一般,*,*,*,*,シェフ,シェフ,シェフ
毎日	名詞,副詞可能,*,*,*,*,毎日,マイニチ,マイニチ
腕	名詞,一般,*,*,*,*,腕,ウデ,ウデ
振るっ	動詞,自立,*,*,五段・ワ行促音便,連用タ接続,振るう,フルッ,フルッ
ハラール	名詞,一般,*,*,*,*,*
客層	名詞,一般,*,*,*,*,客層,キャクソウ,キャクソー
向き	名詞,接尾,一般,*,*,*,向き,ムキ,ムキ
練馬	名詞,固有名詞,地域,一般,*,*,練馬,ネリマ,ネリマ
アヤソフィヤ	名詞,一般,*,*,*,*,*
練馬	名詞,固有名詞,一般,*,*,*,練馬,ネリマ,ネリマ
コンフォート	名詞,一般,*,*,*,*,*
ドルジャマフセン	名詞,一般,*,*,*,*,*
好評	名詞,一般,*,*,*,*,好評,コウヒョウ,コーヒョー
頂き	動詞,自立,*,*,五段・カ行イ音便,連用形,頂く,イタダキ,イタダキ
度々	副詞,助詞類接続,*,*,*,*,度々,タビタビ,タビタビ
まし	助動詞,*,*,*,特殊・マス,連用形,ます,マシ,マシ
ハチノス	名詞,一般,*,*,*,*,*
カクテル	名詞,一般,*,*,*,*,カクテル,カクテル,カクテル
ハードリカー	名詞,一般,*,*,*,*,*
ビール	名詞,一般,*,*,*,*,ビール,ビール,ビール
小皿	名詞,一般,*,*,*,*,小皿,コザラ,コザラ
ジェンダーフリー	名詞,一般,*,*,*,*,*
男女	名詞,一般,*,*,*,*,男女,ダンジョ,ダンジョ
共用	名詞,サ変接続,*,*,*,*,共用,キョウヨウ,キョーヨー
ロマンチック	名詞,形容動詞語幹,*,*,*,*,ロマンチック,ロマンチック,ロマンチック
フレンドリー	名詞,固有名詞,組織,*,*,*,フレンドリー,フレンドリー,フレンドリー
トランスジェンダー	名詞,一般,*,*,*,*,*
家族	名詞,一般,*,*,*,*,家族,カゾク,カゾク
デビットカード	名詞,一般,*,*,*,*,*
クレジット	名詞,一般,*,*,*,*,クレジット,クレジット,クレジット
カード	名詞,一般,*,*,*,*,カード,カード,カード
道玄坂	名詞,固有名詞,地域,一般,*,*,道玄坂,ドウゲンザカ,ドーゲンザカ
安い	形容詞,自立,*,*,形容詞・アウオ段,基本形,安い,ヤスイ,ヤスイ
作る	動詞,自立,*,*,五段・ラ行,基本形,作る,ツクル,ツクル
本格	名詞,一般,*,*,*,*,本格,ホンカク,ホンカク
満喫	名詞,サ変接続,*,*,*,*,満喫,マンキツ,マンキツ
自家製	名詞,一般,*,*,*,*,自家製,ジカセイ,ジカセイ
ちり	名詞,一般,*,*,*,*,ちり,チリ,チリ
楽しめ	動詞,自立,*,*,一段,連用形,楽しめる,タノシメ,タノシメ
ハラールフード	名詞,一般,*,*,*,*,*
菜食	名詞,サ変接続,*,*,*,*,菜食,サイショク,サイショク
異国	名詞,一般,*,*,*,*,異国,イコク,イコク
情緒	名詞,一般,*,*,*,*,情緒,ジョウチョ,ジョーチョ
感じる	動詞,自立,*,*,一段,基本形,感じる,カンジル,カンジル
店内	名詞,一般,*,*,*,*,店内,テンナイ,テンナイ
親しみ	動詞,自立,*,*,五段・マ行,連用形,親しむ,シタシミ,シタシミ
ケータリング	名詞,一般,*,*,*,*,*
世田谷	名詞,固有名詞,地域,一般,*,*,世田谷,セタガヤ,セタガヤ
北沢	名詞,固有名詞,地域,一般,*,*,北沢,キタザワ,キタザワ
ハニー	名詞,一般,*,*,*,*,*
下北沢	名詞,固有名詞,一般,*,*,*,下北沢,シモキタザワ,シモキタザワ
焼肉	名詞,一般,*,*,*,*,焼肉,ヤキニク,ヤキニク
北沢	名詞,固有名詞,一般,*,*,*,北沢,キタザワ,キタザワ
焼き肉	名詞,一般,*,*,*,*,焼き肉,ヤキニク,ヤキニク
暖炉	名詞,一般,*,*,*,*,暖炉,ダンロ,ダンロ
キッズメニュー	名詞,一般,*,*,*,*,*
サラダ	名詞,一般,*,*,*,*,サラダ,サラダ,サラダ
ドリンク	名詞,一般,*,*,*,*,ドリンク,ドリンク,ドリンク
朝食	名詞,サ変接続,*,*,*,*,朝食,チョウショク,チョーショク
山下	名詞,固有名詞,地域,一般,*,*,山下,ヤマシタ,ヤマシタ
ニューポートビル	名詞,一般,*,*,*,*,*
ゼイティン	名詞,一般,*,*,*,*,*
禁煙	名詞,サ変接続,*,*,*,*,禁煙,キンエン,キンエン
小平	名詞,固有名詞,地域,一般,*,*,小平,コダイラ,コダイラ
学園西	名詞,固有名詞,地域,一般,*,*,学園西,ガクエンニシ,ガクエンニシ
ローザ・キッチン	名詞,一般,*,*,*,*,*
店先	名詞,一般,*,*,*,*,店先,ミセサキ,ミセサキ
受取	名詞,一般,*,*,*,*,受取,ウケトリ,ウケトリ
接触	名詞,サ変接続,*,*,*,*,接触,セッショク,セッショク
デリバリー	名詞,一般,*,*,*,*,デリバリー,デリバリー,デリバリー
銀座	名詞,固有名詞,地域,一般,*,*,銀座,ギンザ,ギンザ
イスタンブール	名詞,固有名詞,地域,一般,*,*,イスタンブール,イスタンブール,イスタンブール
本場	名詞,一般,*,*,*,*,本場,ホンバ,ホンバ
あふれる	動詞,自立,*,*,一段,基本形,あふれる,アフレル,アフレル
バラエティ	名詞,一般,*,*,*,*,*
堪能	名詞,サ変接続,*,*,*,*,堪能,タンノウ,タンノー
合う	動詞,自立,*,*,五段・ワ行促音便,基本形,合う,アウ,アウ
取り揃え	動詞,自立,*,*,一段,連用形,取り揃える,トリソロエ,トリソロエ
お茶	名詞,一般,*,*,*,*,お茶,オチャ,オチャ
貼っ	動詞,自立,*,*,五段・ラ行,連用タ接続,貼る,ハッ,ハッ
あり	動詞,非自立,*,*,五段・ラ行,連用形,ある,アリ,アリ
ので	助詞,接続助詞,*,*,*,*,ので,ノデ,ノデ
興味	名詞,一般,*,*,*,*,興味,キョウミ,キョーミ
かも	助詞,副助詞,*,*,*,*,かも,カモ,カモ
しれ	動詞,自立,*,*,一段,連用形,しれる,シレ,シレ
鶴屋	名詞,固有名詞,地域,一般,*,*,鶴屋,ツルヤ,ツルヤ
パイプ	名詞,一般,*,*,*,*,パイプ,パイプ,パイプ
欧風	名詞,一般,*,*,*,*,欧風,オウフウ,オーフー
谷川	名詞,固有名詞,人名,姓,*,*,谷川,タニガワ,タニガワ
ビルディング	名詞,一般,*,*,*,*,ビルディング,ビルディング,ビルディング
エレベーター	名詞,一般,*,*,*,*,エレベーター,エレベーター,エレベーター
食べ	動詞,自立,*,*,一段,連用形,食べる,タベ,タベ
放題	名詞,接尾,一般,*,*,*,放題,ホウダイ,ホーダイ
子ども	名詞,一般,*,*,*,*,子ども,コドモ,コドモ
椅子	名詞,一般,*,*,*,*,椅子,イス,イス
美味しかっ	形容詞,自立,*,*,形容詞・イ段,連用タ接続,美味しい,オイシカッ,オイシカッ
調布	名詞,固有名詞,地域,一般,*,*,調布,チョウフ,チョーフ
飛田給	名詞,固有名詞,地域,一般,*,*,飛田給,トビタキュウ,トビタキュー
豊島	名詞,固有名詞,地域,一般,*,*,豊島,トシマ,トシマ
西池袋	名詞,固有名詞,地域,一般,*,*,西池袋,ニシイケブクロ,ニシイケブクロ
トルコアズ	名詞,一般,*,*,*,*,*
気	名詞,非自立,一般,*,*,*,気,キ,キ
取ら	動詞,自立,*,*,五段・ラ行,未然形,取る,トラ,トラ
メゼ	名詞,一般,*,*,*,*,*
串焼き	名詞,一般,*,*,*,*,串焼き,クシヤキ,クシヤキ
タイル	名詞,一般,*,*,*,*,タイル,タイル,タイル
飾ら	動詞,自立,*,*,五段・ラ行,未然形,飾る,カザラ,カザラ
落ち着い	動詞,自立,*,*,五段・カ行イ音便,連用タ接続,落ち着く,オチツイ,オチツイ
セット	名詞,一般,*,*,*,*,セット,セット,セット
グルーヴ	名詞,一般,*,*,*,*,*
コロナ	名詞,一般,*,*,*,*,コロナ,コロナ,コロナ
禍	名詞,接尾,一般,*,*,*,禍,カ,カ
ようやく	副詞,一般,*,*,*,*,ようやく,ヨウヤク,ヨーヤク
先日	名詞,副詞可能,*,*,*,*,先日,センジツ,センジツ
久々	名詞,一般,*,*,*,*,久々,ヒサビサ,ヒサビサ
会い	動詞,自立,*,*,五段・ワ行促音便,連用形,会う,アイ,アイ
片言	名詞,一般,*,*,*,*,片言,カタコト,カタコト
思い出せ	動詞,自立,*,*,一段,連用形,思い出せる,オモイダセ,オモイダセ
外神田	名詞,固有名詞,地域,一般,*,*,外神田,ソトカンダ,ソトカンダ
イサミヤ	名詞,一般,*,*,*,*,*
㐧	名詞,一般,*,*,*,*,*
デニズ	名詞,一般,*,*,*,*,*
ターキッシュ	名詞,一般,*,*,*,*,*
＆	記号,一般,*,*,*,*,＆,アンド,アンド
神田	名詞,固有名詞,地域,一般,*,*,神田,カンダ,カンダ
挨拶	名詞,サ変接続,*,*,*,*,挨拶,アイサツ,アイサツ
出来れ	動詞,自立,*,*,一段,仮定形,出来る,デキレ,デキレ
大田	名詞,固有名詞,地域,一般,*,*,大田,オオタ,オータ
蒲田	名詞,固有名詞,地域,一般,*,*,蒲田,カマタ,カマタ
太陽	名詞,一般,*,*,*,*,太陽,タイヨウ,タイヨー
ユルディズ	名詞,固有名詞,一般,*,*,*,*
ハラル	名詞,一般,*,*,*,*,*
美味しい	形容詞,自立,*,*,形容詞・イ段,基本形,美味しい,オイシイ,オイシイ
赤坂	名詞,固有名詞,地域,一般,*,*,赤坂,アカサカ,アカサカ
サライ	名詞,一般,*,*,*,*,*
ダイニング	名詞,一般,*,*,*,*,ダイニング,ダイニング,ダイニング
自慢	名詞,サ変接続,*,*,*,*,自慢,ジマン,ジマン
ヨーグルト	名詞,一般,*,*,*,*,ヨーグルト,ヨーグルト,ヨーグルト
ヘルシー	名詞,形容動詞語幹,*,*,*,*,ヘルシー,ヘルシー,ヘルシー
ベリー	名詞,一般,*,*,*,*,ベリー,ベリー,ベリー
ショー	名詞,一般,*,*,*,*,ショー,ショー,ショー
赤坂	名詞,固有名詞,人名,姓,*,*,赤坂,アカサカ,アカサカ
マイ	名詞,固有名詞,人名,名,*,*,マイ,マイ,マイ
九段南	名詞,固有名詞,地域,一般,*,*,九段南,クダンミナミ,クダンミナミ
榊原	名詞,固有名詞,組織,*,*,*,榊原,サカキバラ,サカキバラ
ボスボラス	名詞,一般,*,*,*,*,*
ハサン	名詞,一般,*,*,*,*,*
市ケ谷	名詞,固有名詞,地域,一般,*,*,市ケ谷,イチガヤ,イチガヤ
段	名詞,接尾,助数詞,*,*,*,段,ダン,ダン
エキゾチック	名詞,形容動詞語幹,*,*,*,*,エキゾチック,エキゾチック,エキゾチック
味わう	動詞,自立,*,*,五段・ワ行促音便,基本形,味わう,アジワウ,アジワウ
努め	動詞,自立,*,*,一段,連用形,努める,ツトメ,ツトメ
氏	名詞,接尾,人名,*,*,*,氏,シ,シ
漂う	動詞,自立,*,*,五段・ワ行促音便,基本形,漂う,タダヨウ,タダヨウ
味わえる	動詞,自立,*,*,一段,基本形,味わえる,アジワエル,アジワエル
テーブル	名詞,一般,*,*,*,*,テーブル,テーブル,テーブル
マット	名詞,一般,*,*,*,*,マット,マット,マット
書い	動詞,自立,*,*,五段・カ行イ音便,連用タ接続,書く,カイ,カイ
店員	名詞,一般,*,*,*,*,店員,テンイン,テンイン
さん	名詞,接尾,人名,*,*,*,さん,サン,サン
お話	名詞,サ変接続,*,*,*,*,お話,オハナシ,オハナシ
楽しかっ	形容詞,自立,*,*,形容詞・イ段,連用タ接続,楽しい,タノシカッ,タノシカッ
チュルク	名詞,一般,*,*,*,*,*
調和	名詞,サ変接続,*,*,*,*,調和,チョウワ,チョーワ
検証	名詞,サ変接続,*,*,*,*,検証,ケンショウ,ケンショー
源	名詞,接尾,一般,*,*,*,源,ゲン,ゲン
示さ	動詞,自立,*,*,五段・サ行,未然形,示す,シメサ,シメサ
不十分	名詞,形容動詞語幹,*,*,*,*,不十分,フジュウブン,フジューブン
向上	名詞,サ変接続,*,*,*,*,向上,コウジョウ,コージョー
スカラー	名詞,一般,*,*,*,*,スカラー,スカラー,スカラー
サーチ	名詞,一般,*,*,*,*,サーチ,サーチ,サーチ
ɾ	記号,一般,*,*,*,*,*
ʃ	記号,一般,*,*,*,*,*
アナトリア	名詞,一般,*,*,*,*,*
コーカサス	名詞,一般,*,*,*,*,*
オグズ	名詞,一般,*,*,*,*,*
アナトリア・トルコ	名詞,一般,*,*,*,*,*
カラマンリ・トルコ	名詞,一般,*,*,*,*,*
点字	名詞,一般,*,*,*,*,点字,テンジ,テンジ
注意	名詞,サ変接続,*,*,*,*,注意,チュウイ,チューイ
頁	名詞,一般,*,*,*,*,頁,ページ,ページ
ユニ	名詞,固有名詞,人名,一般,*,*,ユニ,ユニ,ユニ
過半数	名詞,一般,*,*,*,*,過半数,カハンスウ,カハンスー
純化	名詞,サ変接続,*,*,*,*,純化,ジュンカ,ジュンカ
並ん	動詞,自立,*,*,五段・バ行,連用タ接続,並ぶ,ナラン,ナラン
実際	副詞,助詞類接続,*,*,*,*,実際,ジッサイ,ジッサイ
分断	名詞,サ変接続,*,*,*,*,分断,ブンダン,ブンダン
領する	動詞,自立,*,*,サ変・－スル,基本形,領する,リョウスル,リョースル
満足	名詞,サ変接続,*,*,*,*,満足,マンゾク,マンゾク
話せ	動詞,自立,*,*,一段,未然形,話せる,ハナセ,ハナセ
若者	名詞,一般,*,*,*,*,若者,ワカモノ,ワカモノ
極めて	副詞,一般,*,*,*,*,極めて,キワメテ,キワメテ
外来	名詞,一般,*,*,*,*,外来,ガイライ,ガイライ
トルキスタン	名詞,一般,*,*,*,*,*
広がる	動詞,自立,*,*,五段・ラ行,基本形,広がる,ヒロガル,ヒロガル
縁	名詞,一般,*,*,*,*,縁,エン,エン
中でも	副詞,一般,*,*,*,*,中でも,ナカデモ,ナカデモ
相互	名詞,一般,*,*,*,*,相互,ソウゴ,ソーゴ
西進	名詞,一般,*,*,*,*,西進,セイシン,セイシン
小	名詞,接尾,一般,*,*,*,小,ショウ,ショー
書記	名詞,一般,*,*,*,*,書記,ショキ,ショキ
呼ぶ	動詞,自立,*,*,五段・バ行,基本形,呼ぶ,ヨブ,ヨブ
かみ合わ	動詞,自立,*,*,五段・ワ行促音便,未然形,かみ合う,カミアワ,カミアワ
握っ	動詞,自立,*,*,五段・ラ行,連用タ接続,握る,ニギッ,ニギッ
ムスタファ・ケマル・アタテュルク	名詞,一般,*,*,*,*,*
推し進め	動詞,自立,*,*,一段,連用形,推し進める,オシススメ,オシススメ
改め	動詞,自立,*,*,一段,連用形,改める,アラタメ,アラタメ
古語	名詞,一般,*,*,*,*,古語,コゴ,コゴ
造語	名詞,サ変接続,*,*,*,*,造語,ゾウゴ,ゾーゴ
置き換える	動詞,自立,*,*,一段,基本形,置き換える,オキカエル,オキカエル
行い	名詞,一般,*,*,*,*,行い,オコナイ,オコナイ
両	接頭詞,名詞接続,*,*,*,*,両,リョウ,リョー
多岐	名詞,一般,*,*,*,*,多岐,タキ,タキ
わたっ	動詞,自立,*,*,五段・ラ行,連用タ接続,わたる,ワタッ,ワタッ
置換	名詞,サ変接続,*,*,*,*,置換,チカン,チカン
ç	名詞,固有名詞,組織,*,*,*,*
ş	名詞,固有名詞,組織,*,*,*,*
ğ	名詞,固有名詞,組織,*,*,*,*
ı	名詞,固有名詞,組織,*,*,*,*
ö	名詞,固有名詞,組織,*,*,*,*
ü	名詞,固有名詞,組織,*,*,*,*
音素	名詞,一般,*,*,*,*,音素,オンソ,オンソ
唇音	名詞,一般,*,*,*,*,唇音,シンオン,シンオン
歯音	名詞,一般,*,*,*,*,歯音,シオン,シオン
歯茎	名詞,一般,*,*,*,*,歯茎,ハグキ,ハグキ
音	名詞,接尾,一般,*,*,*,音,オン,オン
後部	名詞,一般,*,*,*,*,後部,コウブ,コーブ
硬	形容詞,自立,*,*,形容詞・アウオ段,ガル接続,硬い,カタ,カタ
口蓋	名詞,一般,*,*,*,*,口蓋,コウガイ,コーガイ
軟口蓋	名詞,一般,*,*,*,*,軟口蓋,ナンコウガイ,ナンコーガイ
声門	名詞,一般,*,*,*,*,声門,セイモン,セイモン
鼻音	名詞,一般,*,*,*,*,鼻音,ビオン,ビオン
有	名詞,サ変接続,*,*,*,*,有,ユウ,ユー
声	名詞,接尾,一般,*,*,*,声,ゴエ,ゴエ
唇	名詞,一般,*,*,*,*,唇,クチビル,クチビル
歯	名詞,一般,*,*,*,*,歯,ハ,ハ
破裂	名詞,サ変接続,*,*,*,*,破裂,ハレツ,ハレツ
無声音	名詞,一般,*,*,*,*,無声音,ムセイオン,ムセイオン
無声	名詞,一般,*,*,*,*,無声,ムセイ,ムセイ
破	動詞,自立,*,*,五段・ラ行,体言接続特殊２,破る,ヤブ,ヤブ
擦	動詞,自立,*,*,五段・ラ行,体言接続特殊２,擦る,コス,コス
音	名詞,一般,*,*,*,*,音,オト,オト
͡ʃ	記号,一般,*,*,*,*,*
有声音	名詞,一般,*,*,*,*,有声音,ユウセイオン,ユーセイオン
͡ʒ	記号,一般,*,*,*,*,*
ɟ	記号,一般,*,*,*,*,*
ɡ	記号,一般,*,*,*,*,*
摩擦音	名詞,一般,*,*,*,*,摩擦音,マサツオン,マサツオン
ʒ	記号,一般,*,*,*,*,*
接近	名詞,サ変接続,*,*,*,*,接近,セッキン,セッキン
ɫ	記号,一般,*,*,*,*,*
ɰ	記号,一般,*,*,*,*,*
じき	名詞,副詞可能,*,*,*,*,じき,ジキ,ジキ
たたき	名詞,接尾,一般,*,*,*,たたき,タタキ,タタキ
はじき	動詞,自立,*,*,五段・カ行イ音便,連用形,はじく,ハジキ,ハジキ
ı	名詞,一般,*,*,*,*,*
ö	名詞,一般,*,*,*,*,*
ü	名詞,一般,*,*,*,*,*
表	名詞,一般,*,*,*,*,表,ヒョウ,ヒョー
舌	名詞,一般,*,*,*,*,舌,シタ,シタ
円	名詞,一般,*,*,*,*,円,エン,エン
広	接頭詞,名詞接続,*,*,*,*,広,ヒロ,ヒロ
狭	形容詞,自立,*,*,形容詞・アウオ段,ガル接続,狭い,セマ,セマ
後	接頭詞,名詞接続,*,*,*,*,後,コウ,コー
細い	形容詞,自立,*,*,形容詞・アウオ段,基本形,細い,ホソイ,ホソイ
太い	形容詞,自立,*,*,形容詞・アウオ段,基本形,太い,フトイ,フトイ
語	名詞,接尾,助数詞,*,*,*,語,ゴ,ゴ
共存	名詞,サ変接続,*,*,*,*,共存,キョウゾン,キョーゾン
狭い	形容詞,自立,*,*,形容詞・アウオ段,基本形,狭い,セマイ,セマイ
整然	名詞,一般,*,*,*,*,整然,セイゼン,セイゼン
点	名詞,一般,*,*,*,*,点,テン,テン
付く	動詞,自立,*,*,五段・カ行イ音便,基本形,付く,ツク,ツク
付か	動詞,自立,*,*,五段・カ行イ音便,未然形,付く,ツカ,ツカ
覚える	動詞,自立,*,*,一段,基本形,覚える,オボエル,オボエル
分かり	動詞,自立,*,*,五段・ラ行,連用形,分かる,ワカリ,ワカリ
地点	名詞,一般,*,*,*,*,地点,チテン,チテン
表す	動詞,自立,*,*,五段・サ行,基本形,表す,アラワス,アラワス
助詞	名詞,一般,*,*,*,*,助詞,ジョシ,ジョシ
「〜	名詞,サ変接続,*,*,*,*,*
直前	名詞,一般,*,*,*,*,直前,チョクゼン,チョクゼン
使い分ける	動詞,自立,*,*,一段,基本形,使い分ける,ツカイワケル,ツカイワケル
どこ	名詞,代名詞,一般,*,*,*,どこ,ドコ,ドコ
方向	名詞,一般,*,*,*,*,方向,ホウコウ,ホーコー
イズミル	名詞,一般,*,*,*,*,*
イスタンブル	名詞,一般,*,*,*,*,*
アンカラ	名詞,固有名詞,地域,一般,*,*,アンカラ,アンカラ,アンカラ
終わる	動詞,自立,*,*,五段・ラ行,基本形,終わる,オワル,オワル
ガズィアンテプ	名詞,一般,*,*,*,*,*
後	名詞,非自立,副詞可能,*,*,*,後,ノチ,ノチ
→	記号,一般,*,*,*,*,→,→,→
助動詞	名詞,一般,*,*,*,*,助動詞,ジョドウシ,ジョドーシ
末尾	名詞,一般,*,*,*,*,末尾,マツビ,マツビ
付着	名詞,サ変接続,*,*,*,*,付着,フチャク,フチャク
膠着	名詞,サ変接続,*,*,*,*,膠着,コウチャク,コーチャク
語順	名詞,一般,*,*,*,*,語順,ゴジュン,ゴジュン
主語	名詞,一般,*,*,*,*,主語,シュゴ,シュゴ
先頭	名詞,一般,*,*,*,*,先頭,セントウ,セントー
述語	名詞,一般,*,*,*,*,述語,ジュツゴ,ジュツゴ
置く	動詞,自立,*,*,五段・カ行イ音便,基本形,置く,オク,オク
大まか	名詞,形容動詞語幹,*,*,*,*,大まか,オオマカ,オーマカ
置	名詞,一般,*,*,*,*,*
修飾	名詞,サ変接続,*,*,*,*,修飾,シュウショク,シューショク
語形	名詞,一般,*,*,*,*,語形,ゴケイ,ゴケイ
人	名詞,一般,*,*,*,*,人,ヒト,ヒト
男	名詞,一般,*,*,*,*,男,オトコ,オトコ
ドア	名詞,一般,*,*,*,*,ドア,ドア,ドア
ゲート	名詞,一般,*,*,*,*,ゲート,ゲート,ゲート
ç	名詞,一般,*,*,*,*,*
定性	名詞,一般,*,*,*,*,定性,テイセイ,テイセイ
定	接頭詞,名詞接続,*,*,*,*,定,テイ,テイ
与格	名詞,一般,*,*,*,*,与格,ヨカク,ヨカク
処	名詞,サ変接続,*,*,*,*,処,ショ,ショ
奪	接頭詞,名詞接続,*,*,*,*,奪,ダツ,ダツ
家	名詞,一般,*,*,*,*,家,イエ,イエ
種	名詞,一般,*,*,*,*,種,タネ,タネ
村	名詞,一般,*,*,*,*,村,ムラ,ムラ
指輪	名詞,一般,*,*,*,*,指輪,ユビワ,ユビワ
ミルク	名詞,一般,*,*,*,*,ミルク,ミルク,ミルク
ğü	名詞,一般,*,*,*,*,*
不規則	名詞,一般,*,*,*,*,不規則,フキソク,フキソク
息子	名詞,一般,*,*,*,*,息子,ムスコ,ムスコ
ゴール	名詞,一般,*,*,*,*,ゴール,ゴール,ゴール
代名詞	名詞,一般,*,*,*,*,代名詞,ダイメイシ,ダイメイシ
指示	名詞,サ変接続,*,*,*,*,指示,シジ,シジ
一人称	名詞,一般,*,*,*,*,一人称,イチニンショウ,イチニンショー
二人称	名詞,一般,*,*,*,*,二人称,ニニンショウ,ニニンショー
あれ	名詞,代名詞,一般,*,*,*,あれ,アレ,アレ
尊敬	名詞,サ変接続,*,*,*,*,尊敬,ソンケイ,ソンケイ
私	名詞,代名詞,一般,*,*,*,私,ワタシ,ワタシ
手紙	名詞,一般,*,*,*,*,手紙,テガミ,テガミ
に当たる	助詞,格助詞,連語,*,*,*,に当たる,ニアタル,ニアタル
書く	動詞,自立,*,*,五段・カ行イ音便,基本形,書く,カク,カク
当たる	動詞,自立,*,*,五段・ラ行,基本形,当たる,アタル,アタル
主題	名詞,一般,*,*,*,*,主題,シュダイ,シュダイ
上	名詞,一般,*,*,*,*,上,ウエ,ウエ
つまり	名詞,一般,*,*,*,*,つまり,ツマリ,ツマリ
聴者	名詞,一般,*,*,*,*,*
分かる	動詞,自立,*,*,五段・ラ行,基本形,分かる,ワカル,ワカル
不要	名詞,形容動詞語幹,*,*,*,*,不要,フヨウ,フヨー
通	名詞,接尾,助数詞,*,*,*,通,ツウ,ツー
所有	名詞,サ変接続,*,*,*,*,所有,ショユウ,ショユー
接辞	名詞,一般,*,*,*,*,接辞,セツジ,セツジ
後ろ	名詞,一般,*,*,*,*,後ろ,ウシロ,ウシロ
三人称	名詞,一般,*,*,*,*,三人称,サンニンショウ,サンニンショー
交替	名詞,サ変接続,*,*,*,*,交替,コウタイ,コータイ
冷蔵庫	名詞,一般,*,*,*,*,冷蔵庫,レイゾウコ,レイゾーコ
氷	名詞,一般,*,*,*,*,氷,コオリ,コーリ
たんす	名詞,一般,*,*,*,*,たんす,タンス,タンス
アヤ	名詞,一般,*,*,*,*,アヤ,アヤ,アヤ
終止	名詞,サ変接続,*,*,*,*,終止,シュウシ,シューシ
猫	名詞,一般,*,*,*,*,猫,ネコ,ネコ
犬	名詞,一般,*,*,*,*,犬,イヌ,イヌ
黄色い	形容詞,自立,*,*,形容詞・アウオ段,基本形,黄色い,キイロイ,キイロイ
否定	名詞,サ変接続,*,*,*,*,否定,ヒテイ,ヒテイ
時制	名詞,一般,*,*,*,*,時制,ジセイ,ジセイ
かっ	動詞,自立,*,*,五段・ラ行,連用タ接続,かる,カッ,カッ
歩く	動詞,自立,*,*,五段・カ行イ音便,基本形,歩く,アルク,アルク
歩か	動詞,自立,*,*,五段・カ行イ音便,未然形,歩く,アルカ,アルカ
不定	名詞,一般,*,*,*,*,不定,フテイ,フテイ
詞	名詞,一般,*,*,*,*,詞,コトバ,コトバ
直	接頭詞,名詞接続,*,*,*,*,直,チョク,チョク
説法	名詞,サ変接続,*,*,*,*,説法,セッポウ,セッポー
アオリスト	名詞,一般,*,*,*,*,*
推論	名詞,サ変接続,*,*,*,*,推論,スイロン,スイロン
希求	名詞,サ変接続,*,*,*,*,希求,キキュウ,キキュー
命令	名詞,サ変接続,*,*,*,*,命令,メイレイ,メイレイ
願望	名詞,サ変接続,*,*,*,*,願望,ガンボウ,ガンボー
分詞	名詞,一般,*,*,*,*,分詞,ブンシ,ブンシ
動	名詞,一般,*,*,*,*,動,ドウ,ドー
書き方	名詞,一般,*,*,*,*,書き方,カキカタ,カキカタ
ış	名詞,一般,*,*,*,*,*
あらわす	動詞,自立,*,*,五段・サ行,基本形,あらわす,アラワス,アラワス
ハンドブック	名詞,一般,*,*,*,*,ハンドブック,ハンドブック,ハンドブック
林	名詞,固有名詞,人名,姓,*,*,林,ハヤシ,ハヤシ
徹	名詞,固有名詞,人名,名,*,*,徹,トオル,トール
白水	名詞,一般,*,*,*,*,白水,シロミズ,シロミズ
発行	名詞,サ変接続,*,*,*,*,発行,ハッコウ,ハッコー
図説	名詞,サ変接続,*,*,*,*,図説,ズセツ,ズセツ
和彦	名詞,固有名詞,人名,名,*,*,和彦,カズヒコ,カズヒコ
河出書房新社	名詞,固有名詞,組織,*,*,*,河出書房新社,カワデショボウシンシャ,カワデショボーシンシャ
梶	名詞,固有名詞,人名,姓,*,*,梶,カジ,カジ
茂樹	名詞,固有名詞,人名,名,*,*,茂樹,シゲキ,シゲキ
由美	名詞,固有名詞,人名,名,*,*,由美,ユミ,ユミ
大修館書店	名詞,固有名詞,組織,*,*,*,大修館書店,タイシュウカンショテン,タイシューカンショテン
ビジュアル	名詞,形容動詞語幹,*,*,*,*,ビジュアル,ビジュアル,ビジュアル
現用	名詞,サ変接続,*,*,*,*,現用,ゲンヨウ,ゲンヨー
絶滅	名詞,サ変接続,*,*,*,*,絶滅,ゼツメツ,ゼツメツ
ピーター	名詞,固有名詞,人名,名,*,*,ピーター,ピーター,ピーター
オースティン	名詞,固有名詞,地域,一般,*,*,オースティン,オースティン,オースティン
澤田	名詞,固有名詞,人名,姓,*,*,澤田,サワダ,サワダ
治美	名詞,固有名詞,人名,名,*,*,治美,ハルミ,ハルミ
監修	名詞,サ変接続,*,*,*,*,監修,カンシュウ,カンシュー
柊	名詞,一般,*,*,*,*,柊,ヒイラギ,ヒイラギ
風	名詞,接尾,一般,*,*,*,風,フウ,フー
舎	名詞,接尾,一般,*,*,*,舎,シャ,シャ
ステップ	名詞,一般,*,*,*,*,ステップ,ステップ,ステップ
大阪大学	名詞,固有名詞,組織,*,*,*,大阪大学,オオサカダイガク,オーサカダイガク
暗記	名詞,サ変接続,*,*,*,*,暗記,アンキ,アンキ
入力	名詞,サ変接続,*,*,*,*,入力,ニュウリョク,ニューリョク
フォーム	名詞,一般,*,*,*,*,フォーム,フォーム,フォーム
付	名詞,接尾,一般,*,*,*,付,ヅケ,ズケ
祖語	名詞,一般,*,*,*,*,祖語,ソゴ,ソゴ
アルグ	名詞,一般,*,*,*,*,*
ハラジ	名詞,一般,*,*,*,*,*
カルルク	名詞,一般,*,*,*,*,*
エイヌ	名詞,一般,*,*,*,*,*
チャガタイ	名詞,一般,*,*,*,*,*
イリ・チュルク	名詞,一般,*,*,*,*,*
ロプ	名詞,一般,*,*,*,*,*
キプチャク	名詞,一般,*,*,*,*,*
ポントス・カスピ	名詞,一般,*,*,*,*,*
カライム	名詞,一般,*,*,*,*,*
クマン	名詞,一般,*,*,*,*,*
クリムチャク	名詞,一般,*,*,*,*,*
クムク	名詞,一般,*,*,*,*,*
ウルム	名詞,一般,*,*,*,*,*
アラル・カスピ	名詞,一般,*,*,*,*,*
シベリア・タタール	名詞,一般,*,*,*,*,*
フェルガナ・キプチャク	名詞,一般,*,*,*,*,*
ノガイ	名詞,一般,*,*,*,*,*
ウラル・カスピ	名詞,一般,*,*,*,*,*
アフシャール	名詞,一般,*,*,*,*,*
バルカン・ガガウズ・トルコ	名詞,一般,*,*,*,*,*
ホラサン・トルコ	名詞,一般,*,*,*,*,*
ペチェネグ	名詞,一般,*,*,*,*,*
ガシュガーイー	名詞,一般,*,*,*,*,*
サラール	名詞,一般,*,*,*,*,*
シベリア・チュルク	名詞,一般,*,*,*,*,*
チュリム	名詞,一般,*,*,*,*,*
富裕	名詞,一般,*,*,*,*,富裕,フユウ,フユー
ハカス	名詞,一般,*,*,*,*,*
ショル	名詞,一般,*,*,*,*,*
トファ	名詞,一般,*,*,*,*,*
トゥバ	名詞,一般,*,*,*,*,*
ユグル	名詞,一般,*,*,*,*,*
オグール	名詞,一般,*,*,*,*,*
ガール	名詞,一般,*,*,*,*,ガール,ガール,ガール
ハザール	名詞,一般,*,*,*,*,*
論争	名詞,サ変接続,*,*,*,*,論争,ロンソウ,ロンソー
有り	動詞,自立,*,*,五段・ラ行,連用形,有る,アリ,アリ
訂正	名詞,サ変接続,*,*,*,*,訂正,テイセイ,テイセイ
くださる	動詞,非自立,*,*,五段・ラ行特殊,基本形,くださる,クダサル,クダサル
Аҭырқәа	名詞,一般,*,*,*,*,*
Тыркубзэ	名詞,一般,*,*,*,*,*
ቱርክኛ	記号,一般,*,*,*,*,*
التركية	記号,一般,*,*,*,*,*
ܛܘܪܩܝܐ	記号,一般,*,*,*,*,*
تركية	記号,一般,*,*,*,*,*
توركى	記号,一般,*,*,*,*,*
Турк	名詞,一般,*,*,*,*,*
мацӀ	名詞,一般,*,*,*,*,*
تورکیه	記号,一般,*,*,*,*,*
تورکجه	記号,一般,*,*,*,*,*
‌	名詞,サ変接続,*,*,*,*,*
سی	記号,一般,*,*,*,*,*
Төрөк	名詞,一般,*,*,*,*,*
Турэцкая	名詞,一般,*,*,*,*,*
Турски	名詞,一般,*,*,*,*,*
তুর্কি	記号,一般,*,*,*,*,*
Түрэг	名詞,一般,*,*,*,*,*
ī	名詞,一般,*,*,*,*,*
Туркойн	名詞,一般,*,*,*,*,*
ᎠᏂᎬᎾ	記号,一般,*,*,*,*,*
ᎧᏬᏂᎯᏍᏗ	記号,一般,*,*,*,*,*
تورکی	記号,一般,*,*,*,*,*
Туркк	名詞,一般,*,*,*,*,*
ă	名詞,一般,*,*,*,*,*
Τουρκική	名詞,一般,*,*,*,*,*
ترکی	記号,一般,*,*,*,*,*
استانبولی	記号,一般,*,*,*,*,*
तुर्की	記号,一般,*,*,*,*,*
भास	記号,一般,*,*,*,*,*
તુર્કિશ	記号,一般,*,*,*,*,*
טורקית	記号,一般,*,*,*,*,*
तुर्कीयाई	記号,一般,*,*,*,*,*
Թուրքերեն	記号,一般,*,*,*,*,*
Թրքերէն	記号,一般,*,*,*,*,*
Туркий	名詞,一般,*,*,*,*,*
თურქული	記号,一般,*,*,*,*,*
Түрік	名詞,一般,*,*,*,*,*
터키어	記号,一般,*,*,*,*,*
Тюрк	名詞,一般,*,*,*,*,*
Турок	名詞,一般,*,*,*,*,*
Түрк	名詞,一般,*,*,*,*,*
Туркнал	名詞,一般,*,*,*,*,*
Туьрк	名詞,一般,*,*,*,*,*
ພາສາທືກເຈ	記号,一般,*,*,*,*,*
Туркань	名詞,一般,*,*,*,*,*
Турко	名詞,一般,*,*,*,*,*
йылме	名詞,一般,*,*,*,*,*
തുർക്കിഷ്	記号,一般,*,*,*,*,*
ꯇꯔꯀꯤꯁ	記号,一般,*,*,*,*,*
йӹлмӹ	名詞,一般,*,*,*,*,*
တူရကီဘာသာစကား	記号,一般,*,*,*,*,*
Турконь	名詞,一般,*,*,*,*,*
ایستامبولی	記号,一般,*,*,*,*,*
तुर्केली	記号,一般,*,*,*,*,*
तर्किश	記号,一般,*,*,*,*,*
Туркаг	名詞,一般,*,*,*,*,*
ਤੁਰਕੀ	記号,一般,*,*,*,*,*
ترک	記号,一般,*,*,*,*,*
بولی	記号,一般,*,*,*,*,*
تورکي	記号,一般,*,*,*,*,*
Турецкий	名詞,一般,*,*,*,*,*
Турецькый	名詞,一般,*,*,*,*,*
Туурак	名詞,一般,*,*,*,*,*
ᱛᱩᱨᱠᱤ	記号,一般,*,*,*,*,*
ترڪي	記号,一般,*,*,*,*,*
துருக்கிய	記号,一般,*,*,*,*,*
туркӣ	名詞,一般,*,*,*,*,*
ภาษาตุรกี	記号,一般,*,*,*,*,*
Төрек	名詞,一般,*,*,*,*,*
تۈرك	記号,一般,*,*,*,*,*
Турецька	名詞,一般,*,*,*,*,*
耳	名詞,一般,*,*,*,*,耳,ミミ,ミミ
其语	名詞,一般,*,*,*,*,*
Түргдин	名詞,一般,*,*,*,*,*
טערקיש	記号,一般,*,*,*,*,*
͘	記号,一般,*,*,*,*,*
其話	名詞,一般,*,*,*,*,*
またがる	動詞,自立,*,*,五段・ラ行,基本形,またがる,マタガル,マタガル
ペルシャ	名詞,固有名詞,地域,一般,*,*,ペルシャ,ペルシャ,ペルシャ
ビザンチン	名詞,固有名詞,地域,一般,*,*,ビザンチン,ビザンチン,ビザンチン
ボスポラス	名詞,一般,*,*,*,*,*
海峡	名詞,一般,*,*,*,*,海峡,カイキョウ,カイキョー
高く	形容詞,自立,*,*,形容詞・アウオ段,連用テ接続,高い,タカク,タカク
そびえる	動詞,自立,*,*,一段,基本形,そびえる,ソビエル,ソビエル
ドーム	名詞,一般,*,*,*,*,ドーム,ドーム,ドーム
キリスト	名詞,固有名詞,一般,*,*,*,キリスト,キリスト,キリスト
モザイク	名詞,一般,*,*,*,*,モザイク,モザイク,モザイク
壮大	名詞,形容動詞語幹,*,*,*,*,壮大,ソウダイ,ソーダイ
ブルー	名詞,一般,*,*,*,*,ブルー,ブルー,ブルー
スルタン	名詞,一般,*,*,*,*,スルタン,スルタン,スルタン
居城	名詞,一般,*,*,*,*,居城,キョジョウ,キョジョー
トプカプ	名詞,一般,*,*,*,*,*
閉店	名詞,サ変接続,*,*,*,*,閉店,ヘイテン,ヘイテン
